    0         10        20        30        40        50        60        70        80        90        100       110       120       130       140       150       
    0123456789012345678901234567890123456789012345678901234567890123456789012345678901234567890123456789012345678901234567890123456789012345678901234567890123456789
0   ________________________________________________________________________________________________________________________________________________________________
1   ________________________________________________________________________________________________________________________________________________________________
2   ________________________________________________________________________________________________________________________________________________________________
3   ________________________________________________________________________________________________________________________________________________________________
4   ________________________________________________________________________________________________________________________________________________________________
5   ________________________________________________________________________________________________________________________________________________________________
6   ________________________________________________________________________________________________________________________________________________________________
7   ________________________________________________________________________________________________________________________________________________________________
8   ________________________________________________________________________________________________________________________________________________________________
9   ________________________________________________________________________________________________________________________________________________________________
10  ________________________________________________________________________________________________________________________________________________________________
11  ________________________________________________________________________________________________________________________________________________________________
12  ________________________________________________________________________________________________________________________________________________________________
13  ________________________________________________________________________________________________________________________________________________________________
14  ________________________________________________________________________________________________________________________________________________________________
15  ________________________________________________________________________________________________________________________________________________________________
16  ________________________________________________________________________________________________________________________________________________________________
17  ________________________________________________________________________________________________________________________________________________________________
18  ________________________________________________________________________________________________________________________________________________________________
19  ________________________________________________________________________________________________________________________________________________________________
20  ________________________________________________________________________________________________________________________________________________________________
21  ________________________________________________________________________________________________________________________________________________________________
22  ________________________________________________________________________________________________________________________________________________________________
23  ________________________________________________________________________________________________________________________________________________________________
24  ________________________________________________________________________________________________________________________________________________________________
25  ________________________________________________________________________________________________________________________________________________________________
26  ________________________________________________________________________________________________________________________________________________________________
27  ________________________________________________________________________________________________________________________________________________________________
28  ________________________________________________________________________________________________________________________________________________________________
29  ________________________________________________________________________________________________________________________________________________________________
30  ________________________________________________________________________________________________________________________________________________________________
31  ________________________________________________________________________________________________________________________________________________________________
32  ________________________________________________________________________________________________________________________________________________________________
33  ________________________________________________________________________________________________________________________________________________________________
34  ________________________________________________________________________________________________________________________________________________________________
35  ________________________________________________________________________________________________________________________________________________________________
36  ________________________________________________________________________________________________________________________________________________________________
37  ________________________________________________________________________________________________________________________________________________________________
38  ________________________________________________________________________________________________________________________________________________________________
39  ________________________________________________________________________________________________________________________________________________________________
40  ________________________________________________________________________________________________________________________________________________________________
41  1111111111111111111111111111111111111111111111111111111111111111111111111111111111111111111111111111111111111111111111111111111111111111111111111111111111111111
42  ________________________________________________________________________________________________________________________________________________________________
43  ________________________________________________________________________________________________________________________________________________________________
44  ________________________________________________________________________________________________________________________________________________________________
45  ________________________________________________________________________________________________________________________________________________________________
46  ________________________________________________________________________________________________________________________________________________________________
47  ________________________________________________________________________________________________________________________________________________________________
48  ________________________________________________________________________________________________________________________________________________________________
49  ________________________________________________________________________________________________________________________________________________________________
50  ________________________________________________________________________________________________________________________________________________________________
51  ________________________________________________________________________________________________________________________________________________________________
52  ________________________________________________________________________________________________________________________________________________________________
53  ________________________________________________________________________________________________________________________________________________________________
54  ________________________________________________________________________________________________________________________________________________________________
55  ________________________________________________________________________________________________________________________________________________________________
56  ________________________________________________________________________________________________________________________________________________________________
57  ________________________________________________________________________________________________________________________________________________________________
58  ________________________________________________________________________________________________________________________________________________________________
59  ________________________________________________________________________________________________________________________________________________________________
60  ________________________________________________________________________________________________________________________________________________________________
61  _______________________________________________________________________________________________________________________________111______________________________
62  ________________________________________________________________________________________________________________________1__1111___11____________________________
63  _____________________________________________________________________________________________________________________111_11_11111111111_________________________
64  _________________________________________________________________________________________________________________1111__________________111______________________
65  _____________________________________________________________________________________________________________1111_________________________11____________________
66  _________________________________________________________________________________________________________1111_______________________________111_________________
67  ____________________________________________________________________________________________________11111______________________________________11_______________
68  ________________________________________________________________________________________________1111_____________________________________________11_____________
69  ____________________________________________________________________________________________1111_________________________________________________1______________
70  _______________________________________________________________________________________11111____________________________________________________1_______________
71  ______________________________________________________________________________________11________________________________________________________1_______________
72  ___________________________________________________________________________________111_________________________________________________________1________________
73  ________________________________________________________________________________111___________________________________________________________1_________________
74  ____________________________________________________________________________1111_____________________________________________________________1__________________
75  _________________________________________________________________________111________________________________________________________________1___________________
76  _______________________________________________________________________11__________________________________________________________________1____________________
77  _______________________________________________________________________1___________________________________________________________________1____________________
78  ____________________________________________________________11_________1__________________________________________________________________1_____________________
79  ______________________________________________________________111______1_________________________________________________________________1______________________
80  ________________________________________________________________1111__11________________________________________________________________1_______________________
81  ________________________________________________________________1__111_________________________________________________________________1________________________
82  _______________________________________________________________1________________________________________11_____________________________1________________________
83  _______________________________________________________________1______________________________________11__11__________________________1_________________________
84  ______________________________________________________________1_________________111111111___________11______11_______________________1__________________________
85  ______________________________________________________________1_________________1_______1_____________11___11_______________________1___________________________
86  _____________________________________________________________1__________________1_______1_______________111________________________1____________________________
87  _____________________________________________________________1__________________1_______1_________________________________________1_____________________________
88  ____________________________________________________________1____________________11_____1_________________________________________1_____________________________
89  ____________________________________________________________1______________________11___1________________________________________1______________________________
90  ___________________________________________________________1_________________________11_1_______________________________________1_______________________________
91  ___________________________________________________________1___________________________11______________________________________1________________________________
92  __________________________________________________________1______________________________11___________________________________1_________________________________
93  _________________________________________________________1_______________________________1_11_________________________________1_________________________________
94  _________________________________________________________1_______________________________1___11______________________________1__________________________________
95  ________________________________________________________1________________________________11111111111________________________1___________________________________
96  _______________________________________________________1_________________________________________111_______________________1____________________________________
97  _______________________________________________________1__________________________________________________________________1_____________________________________
98  ______________________________________________________1__________________________________________________________________1______________________________________
99  ______________________________________________________1____________________________3333__________________________________1______________________________________
100 _____________________________________________________1__________________________333333333_______________________________1_______________________________________
101 ___________________________________________________11__________________________333333333333__________________11111111111________________________________________
102 __________________________________________________1___________________________33333331333333_________________1__________________________________________________
103 ________________________________________________11___________________________3333333131133333________________1__________________________________________________
104 _______________________________________________1_____________________________3333331333311333________________1__________________________________________________
105 _____________________________________________11_____________________________33333313_____3133________________1__________________________________________________
106 ____________________________________________1_______________________________3333331_33333_1333_______________1__________________________________________________
107 __________________________________________11_______________________________33333313_33333_3133_______________11111111111________________________________________
108 _________________________________________1_________________________________3333313_3333333_133_________________________1________________________________________
109 ________________________________1______11_________________________________33333133_3333333_3133________________________1________________________________________
110 ________________________________1_____1___________________________________3333133_333333333_133________________________1________________________________________
111 ________________________________1___11___________________________________3333313_3333333333_313________________________1________________________________________
112 _______1________________________1__1____________________________________33333133_3333333333_313________________________1________________________________________
113 _______1________________________111_____________________________________3333313_3333333333_3133________________________1________________________________________
114 _______1________________________1______________________________________33333133_3333333333_3133________________________1________________________________________
115 _______1______________________111_____________________________________33331133_33333333333_313_________________________1________________________________________
116 _______1_____________________111____________________________________33333133__333333333333_313_________________________1________________________________________
117 _______1___________________111_____________________________________33333133_3333333333333_3133_________________________1________________________________________
118 _______1_________________11_______________________________________3333113__33333333333333_3133_________________________1________________________________________
119 _______1_______________11_______________________________________33333133_3333333333333333_3133_________________________1________________________________________
120 _______1_____________11________________________________________3333113__33333333333333333_133_________________________1_________________________________________
121 _______1___________11_________________________________________3333133_333333333333333333_3133_________________________1_________________________________________
122 _________________11_________________________________________3333313__3333333333333333333_313__________________________1_________________________________________
123 _______1______111__________________________________________3333113_333333333333333333333_313__________________________1_________________________________________
124 _______1111111___________________________________________33333133_333333333333333333333_313___________________________1_________________________________________
125 ___11111________________________________________________3333113__3333333333333333333333_313__________________________1__________________________________________
126 111___1_______________________________________________33333133_33333333333333333333333_313___________________________1__________________________________________
127 _______1_____________________________________________3333313__333333333333333333333333_13____________________________1__________________________________________
128 ______1_____________________________________________3333113_3333333333333333333333333_13_____________________________1__________________________________________
129 _______1__________________________________________3333313__3333333333333333333333333_133____________________________1___________________________________________
130 ________11_______________________________________3333113_33333333333333333333333333_133_____________________________1___________________________________________
131 __________1____________________________________3333313__33333333333333333333333333_133______________________________1___________________________________________
132 1________1____________________________________3333113_333333333333333333333333333_133_______________________________1___________________________________________
133 _1_____11____________________________________3333133_333333333333333333333333333_133________________________________1___________________________________________
134 __1___1____________________________________3333313__333333333333333333333333333_1333_______________________________1____________________________________________
135 __1_11____________________________________3333113_3333333333333333333333333333_1333________________________________1____________________________________________
136 ___1____________________________________3333313__3333333333333333333333333333_1333_________________________________1____________________________________________
137 _______________________________________3333113_33333333333333333333333333333_1333_________________________________1_____________________________________________
138 _____________________________________3333313__33333333333333333333333333333_1333__________________________________1_____________________________________________
139 ____________________________________3333313_333333333333333333333333333333_1333__________________________________1______________________________________________
140 ___________________________________333311__333333333333333333333333333333_13333_________________________________1_______________________________________________
141 _________________________________3333313_3333333333333333333333333333333_13333_________________________________1________________________________________________
142 ________________________________3333113_3333333333333333333333333333333_13333__________________________________1________________________________________________
143 ________________________________33313__3333333333333333333333333333333_13333__________________________________1_________________________________________________
144 ________________________________3113_33333333333333333333333333333333_13333__________________________________1__________________________________________________
145 ________________________________13__33333333333333333333333333333333_13333___________________________________1__________________________________________________
146 ______________________________113_333333333333333333333333333333333_13333___________________________________1___________________________________________________
147 ____________________________11__3333333333333333333333333333333333_13333___________________________________1____________________________________________________
148 ___________________________1____333333333333333333333333333333333_13333___________________________________1_____________________________________________________
149 _________________________11_____33333333333333333333333333333333_13333____________________________________1_____________________________________________________
150 _______________________11_______3333333333333333333333333333333_13333____________________________________1______________________________________________________
151 ______________________1_________333333333333333333333333333333_13333____________________________________1_______________________________________________________
152 ____________________11__________33333333333333333333333333333_13333_____________________________________1_______________________________________________________
153 __________________11_____________333333333333333333333333333_13333_____________________________________1________________________________________________________
154 _________________1_______________33333333333333333333333333_13333_____________________________________1_________________________________________________________
155 _______________11________________3333333333333333333333333_1333_______________________________________1_________________________________________________________
156 _____________11__________________333333333333333333333333_1333_______________________________________1__________________________________________________________
157 ___________11____________________33333333333333333333333_1333_______________________________________1___________________________________________________________
158 __________1______________________3333333333333333333333_1333_______________________________________1____________________________________________________________
159 ________11_______________________333333333333333333333_1333________________________________________1____________________________________________________________
160 ______11_________________________33333333333333333333_1333________________________________________1_____________________________________________________________
161 _____1___________________________3333333333333333333_1333________________________________________1______________________________________________________________
162 ___11____________________________333333333333333333_1333_________________________________________1______________________________________________________________
163 _11______________________________33333333333333333_1333_________________________________________1_______________________________________________________________
164 1________________________________3333333333333333_1333_________________________________________1________________________________________________________________
165 _________________________________333333333333333_1333_________________________________________1_________________________________________________________________
166 _________________________________33333333333333_1333__________________________________________1_________________________________________________________________
167 _________________________________3333333333333_1333__________________________________________1__________________________________________________________________
