    0         10        20        30        40        50        60        70        80        90        100       110       120       130       140       150       
    0123456789012345678901234567890123456789012345678901234567890123456789012345678901234567890123456789012345678901234567890123456789012345678901234567890123456789
0   ________________________________________________________________________________________________________________________________________________________________
1   ________________________________________________________________________________________________________________________________________________________________
2   ________________________________________________________________________________________________________________________________________________________________
3   ________________________________________________________________________________________________________________________________________________________________
4   ________________________________________________________________________________________________________________________________________________________________
5   ________________________________________________________________________________________________________________________________________________________________
6   ________________________________________________________________________________________________________________________________________________________________
7   ________________________________________________________________________________________________________________________________________________________________
8   ________________________________________________________________________________________________________________________________________________________________
9   ________________________________________________________________________________________________________________________________________________________________
10  ________________________________________________________________________________________________________________________________________________________________
11  _________________________________________1______________________________________________________________________________________________________________________
12  ________________________________________1_______________________________________________________________________________________________________________________
13  _______________________________________1________________________________________________________________________________________________________________________
14  _______________________________________1________________________________________________________________________________________________________________________
15  ______________________________________1_________________________________________________________________________________________________________________________
16  _____________________________________1__________________________________________________________________________________________________________________________
17  ____________________________________1___________________________________________________________________________________________________________________________
18  ____________________________________1___________________________________________________________________________________________________________________________
19  ___________________________________1____________________________________________________________________________________________________________________________
20  __________________________________1_____________________________________________________________________________________________________________________________
21  __________________________________1_____________________________________________________________________________________________________________________________
22  _________________________________1___________________2__________________________________________________________________________________________________________
23  _________________________________1__________________2___________________________________________________________________________________________________________
24  ________________________________1__________________2____________________________________________________________________________________________________________
25  ________________________________1_________________2_____________________________________________________________________________________________________________
26  _______________________________1______________2222______________________________________________________________________________________________________________
27  _______________________________1______________2_________________________________________________________________________________________________________________
28  _______________________________1______________2_________________________________________________________________________________________________________________
29  ______________________________1______________2__________________________________________________________________________________________________________________
30  ______________________________1______________2__________________________________________________________________________________________________________________
31  _____________________________1_______________2__________________________________________________________________________________________________________________
32  _________________________2___1_______________2__________________________________________________________________________________________________________________
33  _______________________22__11_______________2___________________________________________________________________________________________________________________
34  ______________________2___1_________________2___________________________________________________________________________________________________________________
35  _____________________2_____________________2____________________________________________________________________________________________________________________
36  ____________________2______________________2____________________________________________________________________________________________________________________
37  ____________________2_____________________2_____________________________________________________________________________________________________________________
38  ___________________2______________________2_____________________________________________________________________________________________________________________
39  ___________________2_____________________2______________________________________________________________________________________________________________________
40  __________________2______________________2______________________________________________________________________________________________________________________
41  __________________2______________________2______________________________________________________________________________________________________________________
42  _________________2______________________2_______________________________________________________________________________________________________________________
43  _________________2______________________2_______________________________________________________________________________________________________________________
44  ________________2_____________________22________________________________________________________________________________________________________________________
45  _______________2____________________22__________________________________________________________________________________________________________________________
46  _______________2_____________1____22____________________________________________________________________________________________________________________________
47  ______________2______________1_222______________________________________________________________________________________________________________________________
48  _____________2______________1_1_________________________________________________________________________________________________________________________________
49  ____________2_______________1_1_________________________________________________________________________________________________________________________________
50  ____________2______________1___1________________________________________________________________________________________________________________________________
51  ___________2_______________1___1________________________________________________________________________________________________________________________________
52  __________2_______________1_____1_______________________________________________________________________________________________________________________________
53  __________2_______________1_____1_______________________________________________________________________________________________________________________________
54  _________2_______________1______1_______________________________________________________________________________________________________________________________
55  _________2_______________1______1_______________________________________________________________________________________________________________________________
56  ________2_______________1_______1_______________________________________________________________________________________________________________________________
57  ________2_______________1_______1_______________________________________________________________________________________________________________________________
58  _______2_______________1________1_______________________________________________________________________________________________________________________________
59  _______2_______________1________1_______________________________________________________________________________________________________________________________
60  ______2_______________1__________1______________________________________________________________________________________________________________________________
61  ______2_______________12_________1______________________________________________________________________________________________________________________________
62  _____2_________________2__________1_____________________________________________________________________________________________________________________________
63  _____2________________2___________1____________________________________________________________________________________________________111111___________________
64  ____2_________________2___________1___11111111_________________________________________________________________________________________1_____11111122222________
65  ____2________________2____________1_11________11111111111_____________________________________________________________________________1________________2________
66  ___2_________________2____________11_____________________1111________________1111_____________________________________________________1_________________2_______
67  ___2________________2____________2___________________________1______________1___1______________111____________________________________1_________________2_______
68  ____2_1_____________2____________2____________________________111111111111111___111111111111111___111111111111111111111111111111111111__________________2_______
69  ______1____________2_____________2_______________________________________________________________________________________________________________________2______
70  _____1_____________2_____________2__________1111111___________________________________________________________________________________________________1222______
71  _____1____________2______________2_________1_______11____________________11111111_____________111111111________________________________________________1________
72  ____1_____________2_______________22_______1______1____________2222222222________222222222222__________222222__________________________________________1________
73  ____1____________2__________________2222222_____11______________2____________________________________________22222222222111_____________________________1_______
74  ____1____________2_____________________________1________________2__________________________________________________________11___________________________1_______
75  ___1_____________2_____________________________1_________________2___________________________________________________________11__________________________1______
76  ___1______________2___________________________1_________________2______________________________________________________________1_________________________1______
77  ____1_____________2___________________________1________________2________________________________________________________________11_______________________1______
78  ____1_____________22_________________________1_________________2__________________________________________________________________1_____________________1_______
79  _____1______________2________________________1________________2____________________________________________________________________1____________________1_______
80  _____1_______________22_____________________1___________222222______________________________________________________________________1___________________1_______
81  _____1_________________2____________________1___________2____________________________________________________________________________1__________________1_______
82  _____1__________________22_________________1___________2_____________________________________________________________________________1__________________1_______
83  ____1_____________________22_______________1___________2______________________________________________________________________________1_________________1_______
84  ____1_______________________2_____________1___________22____________________________________________________________________________111________________1________
85  ____1________________________22___________1___________2___________22____________________________________________________________1111___________________1________
86  ____1__________________________2____111111___________2________2222__22222222222222222222222222222222222222222222222___________11_______________________1________
87  ____1__________________________11111_________________2_____222_____________________________________________________2________11________________________11________
88  _____1______________________________________________2_____2________________________________________________________111111111________________________11__________
89  _____1_____________________________________________2_____2_______________________________________________________________________________________111____________
90  __2221_____________________________________________2____2______________________________________________________________________________________11_______________
91  ___2______________________________________________2_____2___________________________________________________________________________________111_________________
92  ____2____________________________________________2_____2_________________________________________________________________________________111____________________
93  _____2__________________________________________2_____2_______________________________________________________________________________111_______________________
94  ______2________________________________________2_______2____________________________________________________________________________11__________________________
95  _______22_____________________________________2________2_____________________________________________________________________________222________________________
96  _________22________________________________222__________2________________________________________________222222222_______________2222___________________________
97  ___________22__________22222222222222222222_____________2________________________________2222222222222222_________222222222222222_______________________________
98  _____________2222222222__________________________________2_______________________________2______________________________________________________________________
99  __________________________________________________________2______________________________2______________________________________________________________________
100 __________________________________________________________2______________________________2______________________________________________________________________
101 ___________________________________________________________2_____________________________2______________________________________________________________________
102 ___________________________________________________________2_____________________________2______________________________________________________________________
103 ___________________________________________________________2______________________________2_____________________________________________________________________
104 ___________________________________________________________2______________________________2_____________________________________________________________________
105 ___________________________________________________________2______________________________2_____________________________________________________________________
106 ___________________________________________________________2______________________________2_____________________________________________________________________
107 ___________________________________________________________2______________________________2_____________________________________________________________________
108 ___________________________________________________________2______________________________2_____________________________________________________________________
109 ___________________________________________________________2______________________________2_____________________________________________________________________
110 ___________________________________________________________2______________________________2_____________________________________________________________________
111 ___________________________________________________________2______________________________2_____________________________________________________________________
112 ___________________________________________________________2______________________________2_____________________________________________________________________
113 ___________________________________________________________2______________________________2_____________________________________________________________________
114 ___________________________________________________________2______________________________2_____________________________________________________________________
115 ___________________________________________________________2_______________________________2____________________________________________________________________
116 ___________________________________________________________2_______________________________2____________________________________________________________________
117 ___________________________________________________________2_______________________________2____________________________________________________________________
118 ___________________________________________________________2_______________________________2____________________________________________________________________
119 ___________________________________________________________2_______________________________2____________________________________________________________________
120 ___________________________________________________________2_______________________________22222222222__________________________________________________________
121 ___________________________________________________________2__________________________________________2222______________________________________________________
122 ___________________________________________________________2______________________________________________2222__________________________________________________
123 ___________________________________________________________2__________________________________________________2222______________________________________________
124 ___________________________________________________________2______________________________________________________222___________________________________________
125 ___________________________________________________________2_________________________________________________________2__________________________________________
126 ___________________________________________________________2__________________________________________________________2_________________________________________
127 ___________________________________________________________2___________________________________________________________2________________________________________
128 ___________________________________________________________2___________________________________________________________2________________________________________
129 _____________________________________________________11111111111111111111111111111111111111_____________________________2_______________________________________
130 ____________________________________________________1______________________________________111___________________________2______________________________________
131 __________________________________________________221111111___________________________________11__________________________2_____________________________________
132 __________________________________________________2________11111111111__________________________11________________________2_____________________________________
133 ___________________________________________________2__________________111111_____________________1______________________22______________________________________
134 ___________________________________________________2________________________11________________111_____________________22________________________________________
135 ____________________________________________________22________________________111_______111111______________________22__________________________________________
136 ______________________________________________________2__________________________1111111______________________222222____________________________________________
137 _______________________________________________________222___________________________________________________2__________________________________________________
138 __________________________________________________________222_______________________________________________2___________________________________________________
139 _____________________________________________________________2_____________________________________________2____________________________________________________
140 ______________________________________________________________2___________________________________________2_____________________________________________________
141 ______________________________________________________________2__________________________________________2______________________________________________________
142 _____________________________________________________________2__________________________________________2_______________________________________________________
143 _______________________________________222222222222222_____22__________________________________________2________________________________________________________
144 _________________________________222222_______________22__2__________________________________________22_________________________________________________________
145 ______________________________222_______________________22_________________________________2222222222___________________________________________________________
146 ____________________________22____________________________________________________________2_____________________________________________________________________
147 __________________________22_____________________________________________________________2______________________________________________________________________
148 _________________________2____________________________________________________________222_______________________________________________________________________
149 ________________________2_________________________________________________________2222__________________________________________________________________________
150 _______________________2_________________________________________________222222222______________________________________________________________________________
151 _______________________2_______________________________________________22_______________________________________________________________________________________
152 ______________________2______________________________________________22_________________________________________________________________________________________
153 _____________________2_____________________________________________22___________________________________________________________________________________________
154 ____________________2____________________________________________22_____________________________________________________________________________________________
155 ____________________2_____________________________2222_________22_______________________________________________________________________________________________
156 ____________________2_____________________________2___222222222_________________________________________________________________________________________________
157 ___________________2_____________________________22_____________________________________________________________________________________________________________
158 ___________________2__________________________222_______________________________________________________________________________________________________________
159 __________________2_________________________22__________________________________________________________________________________________________________________
160 _________________2__________________________2___________________________________________________________________________________________________________________
161 _________________2_________________________2____________________________________________________________________________________________________________________
162 ________________2__________________________2____________________________________________________________________________________________________________________
163 _______________2___________________________2____________________________________________________________________________________________________________________
164 ______________2___________________________2_____________________________________________________________________________________________________________________
165 ______________2___________________________2_____________________________________________________________________________________________________________________
166 _____________2___________________________2______________________________________________________________________________________________________________________
167 ____________2____________________________2______________________________________________________________________________________________________________________
