    0         10        20        30        40        50        60        70        80        90        100       110       120       130       140       150
    0123456789012345678901234567890123456789012345678901234567890123456789012345678901234567890123456789012345678901234567890123456789012345678901234567890123456789
0   ______________________________________________________1111111111111111111111111111111111111111111111111111111111111111111111111111111111111111111111111111111111
1   ______________________________________________________1________________________________________________________________________________________________________1
2   ______________________________________________________1________________________________________________________________________________________________________1
3   ______________________________________________________1________________________________________________________________________________________________________1
4   ______________________________________________________1________________________________________________________________________________________________________1
5   ______________________________________________________1________________________________________________________________________________________________________1
6   ______________________________________________________1________________________________________________________________________________________________________1
7   ______________________________________________________1________________________________________________________________________________________________________1
8   ______________________________________________________1________________________________________________________________________________________________________1
9   ______________________________________________________1________________________________________________________________________________________________________1
10  ______________________________________________________1________________________________________________________________________________________________________1
11  ______________________________________________________1________________________________________________________________________________________________________1
12  ______________________________________________________1________________________________________________________________________________________________________1
13  ______________________________________________________1________________________________________________________________________________________________________1
14  ______________________________________________________1________________________________________________________________________________________________________1
15  ______________________________________________________1________________________________________________________________________________________________________1
16  ______________________________________________________1________________________________________________________________________________________________________1
17  ______________________________________________________1________________________________________________________________________________________________________1
18  ______________________________________________________1________________________________________________________________________________________________________1
19  ______________________________________________________1________________________________________________________________________________________________________1
20  ______________________________________________________1________________________________________________________________________________________________________1
21  ______________________________________________________1________________________________________________________________________________________________________1
22  ______________________________________________________1________________________________________________________________________________________________________1
23  ______________________________________________________1________________________________________________________________________________________________________1
24  ______________________________________________________1________________________________________________________________________________________________________1
25  ______________________________________________________1________________________________________________________________________________________________________1
26  ______________________________________________________1________________________________________________________________________________________________________1
27  ______________________________________________________1________________________________________________________________________________________________________1
28  ______________________________________________________1________________________________________________________________________________________________________1
29  ______________________________________________________1________________________________________________________________________________________________________1
30  ______________________________________________________1________________________________________________________________________________________________________1
31  ______________________________________________________1________________________________________________________________________________________________________1
32  ______________________________________________________1________________________________________________________________________________________________________1
33  ______________________________________________________1________________________________________________________________________________________________________1
34  ______________________________________________________1________________________________________________________________________________________________________1
35  ______________________________________________________1________________________________________________________________________________________________________1
36  ______________________________________________________1111111111111111111111111111111111111111111111_11111111111111111111111111111111111111111111111111111111111
37  ________________________________________________________________________________________________________________________________________________________________
38  ________________________________________________________________________________________________________________________________________________________________
39  ________________________________________________________________________________________________________________________________________________________________
40  ________________________________________________________________________________________________________________________________________________________________
41  ________________________________________________________________________________________________________________________________________________________________
42  ________________________________________________________________________________________________________________________________________________________________
43  ________________________________________________________________________________________________________________________________________________________________
44  ________________________________________________________________________________________________________________________________________________________________
45  _________________________________________________________________________________________________11_____________________________________________________________
46  ______________________________________________________________________________________________111____________333333333333333333333333___________3333333333333333
47  ____________________________________________________________________________________________11_______________333333333333333333333333___________3333333333333333
48  ____________________________________________________________________________________________1_________________33333333333333333333333333333333333333333333333333
49  ___________________________________________________________________________________________1___________________3333333333333333333333333333333333333333333333333
50  ___________________________________________________________________________________________1____________________333333333333333333333333333333333333333333333333
51  __________________________________________________________________________________________1_____________________333333333333333333333333333333333333333333333333
52  __________________________________________________________________________________________1______________________33333333333333333333333333333333333333333333333
53  __________________________________________________________________________________________1_______________________3333333333333333333333333333333333333333333333
54  _______________________1__________________________________________________________________1________________________333333333333333333333333333333333333333333333
55  _______________________1_________________________________________________________________1_________________________333333333333333333333333333333333333333333333
56  ______________________1__________________________________________________________________1__________________________33333333333333333333333333333333333333333333
57  ______________________1_________________________________________________________________1___________________________33333333333333333333333333333333333333333333
58  _____________________1________________________________________________________________11____________________________33333333333333333333333333333333333333333333
59  _____________________1_______________________________________________________________1_______________________________3333333333333333333333333333333333333333333
60  ____________________1__________________________________________________________111111________________________________3333333333333333333333333333333333333333333
61  ____________________1_________________________________________________________1______________________________________3333333333333333333333333333333333333333333
62  ___________________1_________________________________________________________1_______________________________________3333333333333333333333333333333333333333333
63  ___________________1_________________________________________________________1______________________________________33333333333333333333333333333333333333333333
64  ___________________1________________________________________________________1_______________________________________33333333333333333333333333333333333333333333 HORIZON
65  ___________________1________________________________________________________1______________________________________333333333333333333333333333333333333333333333
66  ___________________1________________________________________________________1______________________________________333333333333333333333333333333333333333333333
67  ___________________1_______________________________________________________1______________________________________3333333333333333333333333333333333333333333333
68  ___________________1_______________________________________________________1_____________________________________33333333333333333333333333333333333333333333333
69  ___________________1______________________________________________________1_____________________________________333333333333333333333333333333333333333333333333
70  ___________________1______________________________________________________1_____________________________________333333333333333333333333333333333333333333333333
71  ___________________1____________________________________________________11_____________________________________3333333333333333333333333333333333333333333333333
72  ___________________1________________________________________________1111______________________________________33333333333333333333333333333333333333333333333333
73  ____________________1_____________________________________1111____11________________________________________3333333333333333333333333333333333333333333333333333
74  ____________________1___________________________________11____1111________________________________________333333333333333333333333333333333333333333333333333333
75  ____________________1_________________________________11_______________________________________________333333333333333333333333333333333333333333333333333333333
76  ____________________1_______________________________11_______________________________________________33333333333333333333333333333333333333333333333333333333333
77  ____________________1_____________________________11_______________________________________________3333333333333333333333333333333333333333333333333333333333333
78  ____________________1__________________________111_______________________________________________333333333333333333333333333333333333333333333333333333333333333
79  ____________________1_______________________111_________________________________________________3333333333333333333333333333333333333333333333333333333333333333
80  ____________________1_____________________11____________________________________________________3333333333333333333333333333333333333333333333333333333333333333
81  ____________________1__________________111_____________________________________________________33333333333333333333333333333333333333333333333333333333333333333
82  ____________________11111___________111__________________________________________________________333333333333333333333333333333333333333333333333333333333333333
83  ___________________11____11111111111______________________________________________________________33333333333333333333333333333333333333333333333333333333333333
84  _____________________1111111______111111111111111111111111111111111_________________________________333333333333333333333333333333333333333333333333333333333333
85  ____________________________11111111111111_________________________1__________________________________3333333333333333333333333333333333333333333333333333333333
86  __________________________________________11________________________1___________________________________33333333333333333333333333333333333333333333333333333333
87  ____________________________________________11_______________________11___________________________________333333333333333333333333333333333333333333333333333333
88  ______________________________________________111111111111_____________1____________________________________3333333333333333333333333333333333333333333333333333
89  __________________________________________________________1_____________1______________________________________3333333333333333333333333333333333333333333333333
90  __________________________________________________________1______________1________________________________________3333333333333333333333333333333333333333333333
91  ___________________________________________________________1______________1_________________________________________33333333333333333333333333333333333333333333
92  ____________________________________________________________11_____________1_________________________________________3333333333333333333333333333333333333333333
93  ______________________________________________________________11____________11________________________________________333333333333333333333333333333333333333333
94  ________________________________________________________________11____________1________________________________________33333333333333333333333333333333333333333
95  __________________________________________________________________1111111______1________________________________________3333333333333333333333333333333333333333
96  _________________________________________________________________________111111111_______________________________________333333333333333333333333333333333333333
97  _________________________________________________________________________________1________________________________________33333333333333333333333333333333333333
98  _________________________________________________________________________________1_________________________________________3333333333333333333333333333333333333
99  __________________________________________________________________________________1_________________________________________333333333333333333333333333333333333
100 _______________________________________________1111_______________________________1__________________________________________33333333333333333333333333333333333
101 ___________________________________________________11_____________________________1__________________________________________33333333333333333333333333333333333
102 _____________________________________________________11___________________________1___________________________________________3333333333333333333333333333333333
103 _______________________________________________________11__1______________________1____________________________________________333333333333333333333333333333333
104 _________________________________________________________11_11____________________1____________________________________________333333333333333333333333333333333
105 ______________________________________________________________11___________________11111_______________________________________333333333333333333333333333333333
106 ________________________________________________________________1__________________1____11____________________________________3333333333333333333333333333333333
107 _________________________________________________________________1_________________1______1___________________________________3333333333333333333333333333333333
108 _________________________________________________________________1_________________11____111__________________________________3333333333333333333333333333333333
109 __________________________________________________________________1________________1_1111____________________________________33333333333333333333333333333333333
110 __________________________________________________________________1________________1_________________________________________33333333333333333333333333333333333
111 ___________________________________________________________________1______________1_________________________________________333333333333333333333333333333333333
112 ____________________________________________________________________1_____________1_________________________________________333333333333333333333333333333333333
113 _____________________________________________________________________1___________1_________________________________________3333333333333333333333333333333333333
114 ______________________________________________________________________1__________1_________________________________________3333333333333333333333333333333333333
115 _______________________________________________________________________111____111_________________________________________33333333333333333333333333333333333333
116 __________________________________________________________________________1111____________________________________________33333333333333333333333333333333333333
117 _______________________________________________11________________________________________________________________________333333333333333333333333333333333333333
118 _______________________________________________1_1111___________________________________________________________________3333333333333333333333333333333333333333
119 ______________________________________________1______111________________________________________________________________3333333333333333333333333333333333333333
120 ______________________________________________1_________11_____________________________________________________________33333333333333333333333333333333333333333
121 ______________________________________________1___________1___________________________________________________________333333333333333333333333333333333333333333
122 ______________________________________________1___________1__________________________________________________________3333333333333333333333333333333333333333333
123 _______________________________________________1___________1_________________________________________________________3333333333333333333333333333333333333333333
124 _______________________________________________1___________1________________________________________________________33333333333333333333333333333333333333333333
125 ________________________________________________1___________1______________________________________________________333333333333333333333333333333333333333333333
126 _________________________________________________11__________1_____________________________________________________333333333333333333333333333333333333333333333
127 ___________________________________________________1_________1____________________________________________________3333333333333333333333333333333333333333333333
128 ____________________________________________________11________1__________________________________________________33333333333333333333333333333333333333333333333
129 ______________________________________________________1________1_________________________________________________33333333333333333333333333333333333333333333333
130 _______________________________________________________11_______1_______________________________________________333333333333333333333333333333333333333333333333
131 _________________________________________________________111____111_____________________________________________333333333333333333333333333333333333333333333333
132 ____________________________________________________________1111___1____________________________________________333333333333333333333333333333333333333333333333
133 ___________________________________________________________________1___________________________________________3333333333333333333333333333333333333333333333333
134 ___________________________________________________________________1___________________________________________3333333333333333333333333333333333333333333333333
135 ___________________________________________________________________1___________________________________________3333333333333333333333333333333333333333333333333
136 ____________________________________________________________________1__________________________________________3333333333333333333333333333333333333333333333333
137 ____________________________________________________________________1___________________________________________333333333333333333333333333333333333333333333333
138 ____________________________________________________________________1___________________________________________333333333333333333333333333333333333333333333333
139 ______________________________1111111_______________________________1____________________________________________33333333333333333333333333333333333333333333333
140 __________________111111111111_______111____________________________1_____________________________________________3333333333333333333333333333333333333333333333
141 ______111111111111_11111___1____________11___________________________1____________________________________________3333333333333333333333333333333333333333333333
142 11111111___11111___1___1___1______________111________________________11____________________________________________333333333333333333333333333333333333333333333
143 ___1___1___1___1___1___1___1_________________11______________________1111__________________________________________333333333333333333333333333333333333333333333
144 ___1___1___1___1___1___1___1__________________1_______________________1_____________________________________________33333333333333333333333333333333333333333333
145 111111111111___1___1___1___1________________11________________________1_____________________________________________33333333333333333333333333333333333333333333
146 _______1111111111111111111111111111111111111___________________________1_____________________________________________3333333333333333333333333333333333333333333
147 _______________________11111___________________________________________1______________________________________________333333333333333333333333333333333333333333
148 _______________________________________________________________________1______________________________________________333333333333333333333333333333333333333333
149 _______________________________________________________________________1_______________________________________________33333333333333333333333333333333333333333
150 _______________________________________________________________________1________________________________________________3333333333333333333333333333333333333333
151 _______________________________________________________________________1_________________________________________________333333333333333333333333333333333333333
152 ______________________________________________________________________1__________________________________________________333333333333333333333333333333333333333
153 ______________________________________________________________________1___________________________________________________33333333333333333333333333333333333333
154 ______________________________________________________________________1____________________________________________________3333333333333333333333333333333333333
155 ______________________________________________________________________1____________________________________________________3333333333333333333333333333333333333
156 ______________________________________________________________________1_____________________________________________________333333333333333333333333333333333333
157 ______________________________________________________________________1_____________________________________________________333333333333333333333333333333333333
158 _____________________________________________________________________1_______________________________________________________33333333333333333333333333333333333
159 _____________________________________________________________________1_______________________________________________________33333333333333333333333333333333333
160 _____________________________________________________________________1_______________________________________________________33333333333333333333333333333333333
161 _____________________________________________________________________1_______________________________________________________33333333333333333333333333333333333
162 ____________________________________________________________________1________________________________________________________33333333333333333333333333333333333
163 ____________________________________________________________________1_________________________________________________________3333333333333333333333333333333333
164 ____________________________________________________________________1_________________________________________________________3333333333333333333333333333333333
165 ____________________________________________________________________1_________________________________________________________3333333333333333333333333333333333
166 ____________________________________________________________________1_________________________________________________________3333333333333333333333333333333333
167 ____________________________________________________________________1_________________________________________________________3333333333333333333333333333333333
