    0         10        20        30        40        50        60        70        80        90        100       110       120       130       140       150       
    0123456789012345678901234567890123456789012345678901234567890123456789012345678901234567890123456789012345678901234567890123456789012345678901234567890123456789
0   ________________________________________________________________________________________________________________________________________________________________
1   ________________________________________________________________________________________________________________________________________________________________
2   ________________________________________________________________________________________________________________________________________________________________
3   ________________________________________________________________________________________________________________________________________________________________
4   ________________________________________________________________________________________________________________________________________________________________
5   ________________________________________________________________________________________________________________________________________________________________
6   ________________________________________________________________________________________________________________________________________________________________
7   ________________________________________________________________________________________________________________________________________________________________
8   ________________________________________________________________________________________________________________________________________________________________
9   ________________________________________________________________________________________________________________________________________________________________
10  ________________________________________________________________________________________________________________________________________________________________
11  ________________________________________________________________________________________________________________________________________________________________
12  ________________________________________________________________________________________________________________________________________________________________
13  ________________________________________________________________________________________________________________________________________________________________
14  ________________________________________________________________________________________________________________________________________________________________
15  ________________________________________________________________________________________________________________________________________________________________
16  ________________________________________________________________________________________________________________________________________________________________
17  ________________________________________________________________________________________________________________________________________________________________
18  ________________________________________________________________________________________________________________________________________________________________
19  ________________________________________________________________________________________________________________________________________________________________
20  ________________________________________________________________________________________________________________________________________________________________
21  ________________________________________________________________________________________________________________________________________________________________
22  ________________________________________________________________________________________________________________________________________________________________
23  ________________________________________________________________________________________________________________________________________________________________
24  ________________________________________________________________________________________________________________________________________________________________
25  ________________________________________________________________________________________________________________________________________________________________
26  ________________________________________________________________________________________________________________________________________________________________
27  ________________________________________________________________________________________________________________________________________________________________
28  ________________________________________________________________________________________________________________________________________________________________
29  ________________________________________________________________________________________________________________________________________________________________
30  ________________________________________________________________________________________________________________________________________________________________
31  ________________________________________________________________________________________________________________________________________________________________
32  ________________________________________________________________________________________________________________________________________________________________
33  ________________________________________________________________________________________________________________________________________________________________
34  ________________________________________________________________________________________________________________________________________________________________
35  ________________________________________________________________________________________________________________________________________________________________
36  ________________________________________________________________________________________________________________________________________________________________
37  ________________________________________________________________________________________________________________________________________________________________
38  ________________________________________________________________________________________________________________________________________________________________
39  ________________________________________________________________________________________________________________________________________________________________
40  ________________________________________________________________________________________________________________________________________________________________
41  ________________________________________________________________________________________________________________________________________________________________
42  ________________________________________________________________________________________________________________________________________________________________
43  ________________________________________________________________________________________________________________________________________________________________
44  ________________________________________________________________________________________________________________________________________________________________
45  ________________________________________________________________________________________________________________________________________________________________
46  ________________________________________________________________________________________________________________________________________________________________
47  ________________________________________________________________________________________________________________________________________________________________
48  ________________________________________________________________________________________________________________________________________________________________
49  ________________________________________________________________________________________________________________________________________________________________
50  ________________________________________________________________________________________________________________________________________________________________
51  ________________________________________________________________________________________________________________________________________________________________
52  ________________________________________________________________________________________________________________________________________________________________
53  ________________________________________________________________________________________________________________________________________________________________
54  ________________________________________________________________________________________________________________________________________________________________
55  ________________________________________________________________________________________________________________________________________________________________
56  ________________________________________________________________________________________________________________________________________________________________
57  ________________________________________________________________________________________________________________________________________________________________
58  ________________________________________________________________________________________________________________________________________________________________
59  ________________________________________________________________________________________________________________________________________________________________
60  ________________________________________________________________________________________________________________________________________________________________
61  ________________________________________________________________________________________________________________________________________________________________
62  ________________________________________________________________________________________________________________________________________________________________
63  ________________________________________________________________________________________________________________________________________________________________
64  ________________________________________________________________________________________________________________________________________________________________
65  ________________________________________________________________________________________________________________________________________________________________
66  ________________________________________________________________________________________________________________________________________________________________
67  ________________________________________________________________________________________________________________________________________________________________
68  ________________________________________________________________________________________________________________________________________________________________
69  ________________________________________________________________________________________________________________________________________________________________
70  ________________________________________________________________________________________________________________________________________________________________
71  ________________________________________________________________________________________________________________________________________________________________
72  ________________________________________________________________________________________________________________________________________________________________
73  ________________________________________________________________________________________________________________________________________________________________
74  ________________________________________________________________________________________________________________________________________________________________
75  ________________________________________________________________________________________________________________________________________________________________
76  ________________________________________________________________________________________________________________________________________________________________
77  ________________________________________________________________________________________________________________________________________________________________
78  ________________________________________________________________________________________________________________________________________________________________
79  ________________________________________________________________________________________________________________________________________________________________
80  ________________________________________________________________________________________________________________________________________________________________
81  ________________________________________________________________________________________________________________________________________________________________
82  ________________________________________________________________________________________________________________________________________________________________
83  ________________________________________________________________________________________________________________________________________________________________
84  ________________________________________________________________________________________________________________________________________________________________
85  ________________________________________________________________________________________________________________________________________________________________
86  ________________________________________________________________________________________________________________________________________________________________
87  ________________________________________________________________________________________________________________________________________________________________
88  ________________________________________________________________________________________________________________________________________________________________
89  ________________________________________________________________________________________________________________________________________________________________
90  ________________________________________________________________________________________________________________________________________________________________
91  ________________________________________________________________________________________________________________________________________________________________
92  ________________________________________________________________________________________________________________________________________________________________
93  ________________________________________________________________________________________________________________________________________________________________
94  ________________________________________________________________________________________________________________________________________________________________
95  ________________________________________________________________________________________________________________________________________________________________
96  ________________________________________________________________________________________________________________________________________________________________
97  ________________________________________________________________________________________________________________________________________________________________
98  ________________________________________________________________________________________________________________________________________________________________
99  ________________________________________________________________________________________________________________________________________________________________
100 ________________________________________________________________________________________________________________________________________________________________
101 ________________________________________________________________________________________________________________________________________________________________
102 ________________________________________________________________________________________________________________________________________________________________
103 ________________________________________________________________________________________________________________________________________________________________
104 ________________________________________________________________________________________________________________________________________________________________
105 ________________________________________________________________________________________________________________________________________________________________
106 ________________________________________________________________________________________________________________________________________________________________
107 ________________________________________________________________________________________________________________________________________________________________
108 ________________________________________________________________________________________________________________________________________________________________
109 ________________________________________________________________________________________________________________________________________________________________
110 ________________________________________________________________________________________________________________________________________________________________
111 ________________________________________________________________________________________________________________________________________________________________
112 ________________________________________________________________________________________________________________________________________________________________
113 ________________________________________________________________________________________________________________________________________________________________
114 ________________________________________________________________________________________________________________________________________________________________
115 ________________________________________________________________________________________________________________________________________________________________
116 ________________________________________________________________________________________________________________________________________________________________
117 ________________________________________________________________________________________________________________________________________________________________
118 ________________________________________________________________________________________________________________________________________________________________
119 ________________________________________________________________________________________________________________________________________________________________
120 ________________________________________________________________________________________________________________________________________________________________
121 ______________________________________________________________________________________________________________11111_____________________________________________
122 ______________________________________________________________________1111__111111___________11111____11111___1___1___11111_____________________________________
123 ______________________________________________________________________1__1__1____1____111111_1___1____1___1___1___1___1___1_____________________________________
124 ______________________________________________________________________1__1__1____1____1____1_1___1____1___1___1___1___1___1_11111____111111_____________________
125 ______________________________________________________________________1__1__1____1____1____1_1___1____1___1___1___1___1___1_1___1____1____1_____________________
126 __________________________________________________________________11111__1111____1____1____1_1___111111___11111___11111___1_1___1____1____1_____________________
127 __________________________________________________________________1__111111111111111111111_1_1_11111111111111111111111111_1_1___1____1____1_____________________
128 _________________________________________________________11111____1__1____________________11111__________________________1111___1____1____11111_________________
129 ________________________________________11111__111111____1___1____1__1_____________________11______________________________1111111111111______1_________________
130 __1111__1111__1111___1111__1111__1111___1___1__1____1____1___1____1__1__________________________________________________________________111___1_________________
131 __1__1__1__1__1__1___1__1__1__1__1__1___1___1__1____1____1___1____1_1_____________________________________________________________________1___1_________________
132 __1__1__1__1__1__1___1__1__1__1__1__1___1___1__1____1____1___1____1_1_____________________________________________________________________1___111111____________
133 __1__1__1__1__1__1___1__1__1__1__1__1___1___1__1____1____1___1____1_1_____________________________________________________________________1________1____________
134 111__1111__1111__11111__1111__1111__11111___1111____111111___111111_1_____________________________________________________________________1___1____1____________
135 111111111111111111111111111111111111111111111111111111111111111111111_____________________________________________________________________1__1_1___1____________
136 ___________________________________________________________________________________________________________________________________________111_111_1____________
137 _________________________________________________________________________________________________________________________________________________1_1____________
138 __________________________________________________________________________________________________________________________________________________11____________
139 _________________________________________________________________________________________________1111________________________________________1111111____________
140 111111________________________________________________________________________________________111__1_1111_____________________________________11___1____________
141 ___1__111___________________________________________________________________________________11_____1____1_______________________________________11_1____________
142 ___111111___________________________________________________________________________________1______1____1_________________________________________11____________
143 ___111111___________________________________________________________________________________1111111111111________________________________________11_____________
144 111____________________________________________________________________________________________________________________________________________11_1_____________
145 ______________________________________________________________________________________________________________________________________________1___1_____________
146 ____________________________________________________________________________________________________________________________________________11____1_____________
147 _________________________________________________________________________________________________________________________________________111______1_____________
148 ______________________________________________________________________________________________________1111___________________________1111_11111___1_____________
149 __________________________________________________1111________________________________________________1___1_______________________111_____1___1___1_____________
150 _________________________________________________1___1________________________________________________1___11111111111_111111111111________1___1___1_____________
151 111111111111111111111111_________________________1___1________________________11111111111111111111111111__1111111111111___11111___11111___1___1___1_____________
152 1___11111___11111___11111111111111111111111111111__11111111111111111111111111111___11111___11111___1___1__1___1___1___1___1___1___1___1___1___1___1_____________
153 1___1___1___1___1___1___1___1___1___1___1___1__1___1___1___1___1___1___1___1___1___1___1___1___1___1___1111___1___1___1___1___1___1___1___1___11111_____________
154 1___1___1___1___1___1___1___1___1___1___1___1__1___1___1___1___1___1___1___1___1___1___1___1___1___1__________1___1___1___1___1___1___11111_____________________
155 1___1___1___1___1___1___1___1___1___1___1___1__1___1___1___1___1___1___11111___1___1___1___1___1___1__________11111___11111___11111_____________________________
156 1___1___1___1___11111___11111___11111___11111__11111___11111___11111___________11111___11111___11111____________________________________________________________
157 11111___11111___________________________________________________________________________________________________________________________________________________
158 ________________________________________________________________________________________________________________________________________________________________
159 ________________________________________________________________________________________________________________________________________________________________
160 ________________________________________________________________________________________________________________________________________________________________
161 ________________________________________________________________________________________________________________________________________________________________
162 ________________________________________________________________________________________________________________________________________________________________
163 ________________________________________________________________________________________________________________________________________________________________
164 ________________________________________________________________________________________________________________________________________________________________
165 ________________________________________________________________________________________________________________________________________________________________
166 ________________________________________________________________________________________________________________________________________________________________
167 ________________________________________________________________________________________________________________________________________________________________
