    0         10        20        30        40        50        60        70        80        90        100       110       120       130       140       150       
    0123456789012345678901234567890123456789012345678901234567890123456789012345678901234567890123456789012345678901234567890123456789012345678901234567890123456789
0   ________________________________________________________________________________________________________________________________________________________________
1   ________________________________________________________________________________________________________________________________________________________________
2   ________________________________________________________________________________________________________________________________________________________________
3   ________________________________________________________________________________________________________________________________________________________________
4   ________________________________________________________________________________________________________________________________________________________________
5   ________________________________________________________________________________________________________________________________________________________________
6   ________________________________________________________________________________________________________________________________________________________________
7   ________________________________________________________________________________________________________________________________________________________________
8   ________________________________________________________________________________________________________________________________________________________________
9   ________________________________________________________________________________________________________________________________________________________________
10  ________________________________________________________________________________________________________________________________________________________________
11  1111111111111111111111111111111_________________________________________________________________________________________________________________________________
12  _______________________________1________________________________________________________________________________________________________________________________
13  _______________________________1________________________________________________________________________________________________________________________________
14  ________________________________1_______________________________________________________________________________________________________________________________
15  _________________________________1______________________________________________________________________________________________________________________________
16  __________________________________1_____________________________________________________________________________________________________________________________
17  __________________________________1_____________________________________________________________________________________________________________________________
18  ___________________________________1____________________________________________________________________________________________________________________________
19  ____________________________________1___________________________________________________________________________________________________________________________
20  ____________________________________1___________________________________________________________________________________________________________________________
21  _____________________________________1__________________________________________________________________________________________________________________________
22  ______________________________________1_________________________________________________________________________________________________________________________
23  ______________________________________1_________________________________________________________________________________________________________________________
24  _______________________________________1________________________________________________________________________________________________________________________
25  ________________________________________1_______________________________________________________________________________________________________________________
26  _________________________________________1______________________________________________________________________________________________________________________
27  _________________________________________1______________________________________________________________________________________________________________________
28  __________________________________________1_____________________________________________________________________________________________________________________
29  ___________________________________________1____________________________________________________________________________________________________________________
30  ____________________________________________1___________________________________________________________________________________________________________________
31  _____________________________________________1__________________________________________________________________________________________________________________
32  _____________________________________________1__________________________________________________________________________________________________________________
33  ______________________________________________1_________________________________________________________________________________________________________________
34  _______________________________________________1________________________________________________________________________________________________________________
35  ________________________________________________1_______________________________________________________________________________________________________________
36  _________________________________________________11_____________________________________________________________________________________________________________
37  ___________________________________________________11___________________________________________________________________________________________________________
38  _____________________________________________________11_________________________________________________________________________________________________________
39  _______________________________________________________11_______________________________________________________________________________________________________
40  _________________________________________________________11_____________________________________________________________________________________________________
41  ___________________________________________________________11___________________________________________________________________________________________________
42  _____________________________________________________________111111111111111111111111111111111111111111111111111111111111111111111111111111111111111111111111111
43  ________________________________________________________________________________________________________________________________________________________________
44  ________________________________________________________________________________________________________________________________________________________________
45  ________________________________________________________________________________________________________________________________________________________________
46  _____________________________________________________________1__________________________________________________________________________________________________
47  ____________________________________________________________1___________________________________________________________________________________________________
48  ___________________________________________________________1____________________________________________________________________________________________________
49  ___________________________________________________________1____________________________________________________________________________________________________
50  __________________________________________________________1_____________________________________________________________________________________________________
51  _________________________________________________________1______________________________________________________________________________________________________
52  ________________________________________________________1_______________________________________________________________________________________________________
53  ________________________________________________________1_______________________________________________________________________________________________________
54  _______________________________________________________1________________________________________________________________________________________________________
55  ______________________________________________________1_________________________________________________________________________________________________________
56  _____________________________________________________1__________________________________________________________________________________________________________
57  _____________________________________________________1__________________________________________________________________________________________________________
58  ____________________________________________________1___________________________________________________________________________________________________________
59  ____________________________________________________1___________________________________________________________________________________________________________
60  ____________________________________________________1___________________________________________________________________________________________________________
61  ____________________________________________________1___________________________________________________________________________________________________________
62  _____________________________________________________1__________________________________________________________________________________________________________
63  _____________________________________________________1__________________________________________________________________________________________________________
64  _____________________________________________________1__________________________________________________________________________________________________________
65  _____________________________________________________1__________________________________________________________________________________________________________
66  _____________________________________________________1__________________________________________________________________________________________________________
67  ____________________________________________________1___________________________________________________________________________________________________________
68  ___________________________________________________1____________________________________________________________________________________________________________
69  _________________________________________________11_____________________________________________________________________________________________________________
70  ______________________________________________111_______________________________________________________________________________________________________________
71  ______________________________________________1_________________________________________________________________________________________________________________
72  _____________________________________________1__________________________________________________________________________________________________________________
73  _____________________________________________1__________________________________________________________________________________________________________________
74  ____________________________________________1___________________________________________________________________________________________________________________
75  ____________________________________________1___________________________________________________________________________________________________________________
76  __________________________________________11____________________________________________________________________________________________________________________
77  ________________________________________11______________________________________________________________________________________________________________________
78  ________________________________________1_______________________________________________________________________________________________________________________
79  ________________________________________1_______________________________________________________________________________________________________________________
80  ________________________________________1_______________________________________________________________________________________________________________________
81  _______________________________________1________________________________________________________________________________________________________________________
82  _______________________________________1________________________________________________________________________________________________________________________
83  ______________________________________1_________________________________________________________________________________________________________________________
84  ______________________________________1_________________________________________________________________________________________________________________________
85  _____________________________________1__________________________________________________________________________________________________________________________
86  _____________________________________1__________________________________________________________________________________________________________________________
87  1111_111111111111111111111111111111111111111111111111111111111111_11111111111111111____________________111111111111122222222222222222221111111111112222222222222
88  _________________________________111111___________________________________________1____________________1________________________________________________________
89  ___________________________________1_______________________________________________1__________________1_________________________________________________________
90  __________________________________1________________________________________________11________________11_________________________________________________________
91  _________________________________1___________________________________________________1111111111111111___________________________________________________________
92  ________________________________1_______________________________________________________________________________________________________________________________
93  ________________________________1_______________________________________________________________________________________________________________________________
94  _______________________________1________________________________________________________________________________________________________________________________
95  ______________________________1_________________________________________________________________________________________________________________________________
96  _____________________________1__________________________________________________________________________________________________________________________________
97  _____________________________1__________________________________________________________________________________________________________________________________
98  ____________________________1___________________________________________________________________________________________________________________________________
99  ___________________________1____________________________________________________________________________________________________________________________________
100 ___________________________1____________________________________________________________________________________________________________________________________
101 __________________________1_____________________________________________________________________________________________________________________________________
102 _________________________1______________________________________________________________________________________________________________________________________
103 _________________________1______________________________________________________________________________________________________________________________________
104 ________________________1_______________________________________________________________________________________________________________________________________
105 _______________________1________________________________________________________________________________________________________________________________________
106 _______________________1________________________________________________________________________________________________________________________________________
107 ______________________1_________________________________________________________________________________________________________________________________________
108 _____________________1__________________________________________________________________________________________________________________________________________
109 ____________________1___________________________________________________________________________________________________________________________________________
110 ____________________1___________________________________________________________________________________________________________________________________________
111 ____________________1___________________________________________________________________________________________________________________________________________
112 ____________________1___________________________________________________________________________________________________________________________________________
113 ____________________1___________________________________________________________________________________________________________________________________________
114 ___________________111__________________________________________________________________________________________________________________________________________
115 11111111__________1_11111_11111111111111111111111111111111_11111111_____________________________________________________________________________________________
116 _____1_1__________11__________________________________________1___1__________________111111111111111111111111___________________________________________________
117 _______1__________1___________________________________________1___1________________11________________________11_________________________________________________
118 _______1__________11____________111111111111111_______________1___11111111111111111____________________________1111111111111111122222222222222222222222222222222
119 _______1__________11__________________________________________1_________________________________________________________________________________________________
120 _______1__________11__________________________________________1_________________________________________________________________________________________________
121 _______1__________11__________________________________________1_________________________________________________________________________________________________
122 _______1__________11__________________________________________1_________________________________________________________________________________________________
123 _______1__________11__________________________________________1_________________________________________________________________________________________________
124 _______1__________1___________________________________________1_________________________________________________________________________________________________
125 _______1__________1___________________________________________1_________________________________________________________________________________________________
126 _______1__________1___________________________________________1_________________________________________________________________________________________________
127 _______1__________1___________________________________________1_________________________________________________________________________________________________
128 _______1__________1___________________________________________1_________________________________________________________________________________________________
129 _______1__________1___________________________________________1_________________________________________________________________________________________________
130 _______1__________1__________________________111______________1_________________________________________________________________________________________________
131 _______1__________111111111111111111111111111111111111111111111_________________________________________________________________________________________________
132 _______1__________1__________________________1________111_____1_________________________________________________________________________________________________
133 _______1_________11__________________________1__________1_____1_________________________________________________________________________________________________
134 _______1_____111111__________________________11_________1_____1_________________________________________________________________________________________________
135 _______111111_____1____________________________1111___11______1_________________________________________________________________________________________________
136 _______11_________1________________________________111________1_________________________________________________________________________________________________
137 _______11_________1___________________________________________1_________________________________________________________________________________________________
138 _______11_________1___________________________________________1_________________________________________________________________________________________________
139 _______11_________1___________________________________________1_________________________________________________________________________________________________
140 _______1__________1___________________________________________1____________________________________________________________________________11111________________
141 _______1__________1___________________________________________1_____________1111__________________________11111111______________________111_____111_____________
142 _______1__________1___________________________________________1_________1111____11______________________11_______1____________________11__________1_____________
143 _______1__________1___________________________________________1____________1111___1____________________1_________1____________________11__________1_____________
144 _______1__________1___________________________________________1________________111______________________11_______1______________________11______11______________
145 _______1__________1___________________________________________1___________________________________________11111111________________________111111________________
146 _______1__________1___________________________________________1_________________________________________________________________________________________________
147 _______1__________1___________________________________________1_________________________________________________________________________________________________
148 ______11__________1___________________________________________1_________________________________________________________________________________________________
149 ______11__________1___________________________________________1_________________________________________________________________________________________________
150 ______11__________1___________________________________________1_________________________________________________________________________________________________
151 ______11__________1___________________________________________1_________________________________________________________________________________________________
152 ______11__________1___________________________________________1_________________________________________________________________________________________________
153 _____1_1__________1___________________________________________1_________________________________________________________________________________________________
154 _____1_1__________1___________________________________________1_________________________________________________________________________________________________
155 ____1__1__________1_________________1111111___________________1_________________________________________________________________________________________________
156 ____1111__________111111111111111111111111111111111111111111111_________________________________________________________________________________________________
157 ___1__21__________111___________1____________1__________________________________________________________________________________________________________________
158 ___1____________________________1____________1__________________________________________________________________________________________________________________
159 __1_____________________________1____________1__________________________________________________________________________________________________________________
160 __1_____________________________1____________1__________________________________________________________________________________________________________________
161 _1_______________________________11__________1__________________________________________________________________________________________________________________
162 _1_________________________________11______11___________________________________________________________________________________________________________________
163 1____________________________________111111_____________________________________________________________________________________________________________________
164 1___________________________________________________________________________________________________________________111111111___________________________________
165 1_____________________________________________________________________11111111_____________________________________1_________1__________________________________
166 1___________________________________________________________________11________11__________________________________1___________1_________________________________
167 1__________________________________________________________________1____________1________________________________1_____________1________________________________
