    0         10        20        30        40        50        60        70        80        90        100       110       120       130       140       150       
    0123456789012345678901234567890123456789012345678901234567890123456789012345678901234567890123456789012345678901234567890123456789012345678901234567890123456789
0   ________________________________________________________________________________________________________________________________________________________________
1   ________________________________________________________________________________________________________________________________________________________________
2   ________________________________________________________________________________________________________________________________________________________________
3   ________________________________________________________________________________________________________________________________________________________________
4   ________________________________________________________________________________________________________________________________________________________________
5   ________________________________________________________________________________________________________________________________________________________________
6   ________________________________________________________________________________________________________________________________________________________________
7   ________________________________________________________________________________________________________________________________________________________________
8   ________________________________________________________________________________________________________________________________________________________________
9   ________________________________________________________________________________________________________________________________________________________________
10  ________________________________________________________________________________________________________________________________________________________________
11  ________________________________________________________________________________________________________________________________________________________________
12  ________________________________________________________________________________________________________________________________________________________________
13  ________________________________________________________________________________________________________________________________________________________________
14  ________________________________________________________________________________________________________________________________________________________________
15  ________________________________________________________________________________________________________________________________________________________________
16  ________________________________________________________________________________________________________________________________________________________________
17  ________________________________________________________________________________________________________________________________________________________________
18  ________________________________________________________________________________________________________________________________________________________________
19  ________________________________________________________________________________________________________________________________________________________________
20  ________________________________________________________________________________________________________________________________________________________________
21  ________________________________________________________________________________________________________________________________________________________________
22  ________________________________________________________________________________________________________________________________________________________________
23  ________________________________________________________________________________________________________________________________________________________________
24  ________________________________________________________________________________________________________________________________________________________________
25  ________________________________________________________________________________________________________________________________________________________________
26  ________________________________________________________________________________________________________________________________________________________________
27  ________________________________________________________________________________________________________________________________________________________________
28  ________________________________________________________________________________________________________________________________________________________________
29  ________________________________________________________________________________________________________________________________________________________________
30  ________________________________________________________________________________________________________________________________________________________________
31  ________________________________________________________________________________________________________________________________________________________________
32  ________________________________________________________________________________________________________________________________________________________________
33  ________________________________________________________________________________________________________________________________________________________________
34  ________________________________________________________________________________________________________________________________________________________________
35  ________________________________________________________________________________________________________________________________________________________________
36  ________________________________________________________________________________________________________________________________________________________________
37  ________________________________________________________________________________________________________________________________________________________________
38  ________________________________________________________________________________________________________________________________________________________________
39  ________________________________________________________________________________________________________________________________________________________________
40  ________________________________________________________________________________________________________________________________________________________________
41  1111111111111111111111111111111111111111111111111111111111111111111111111111111111111111111111111111111111111111111111111111111111111111111111111111111111111111
42  ________________________________________________________________________________________________________________________________________________________________
43  ________________________________________________________________________________________________________________________________________________________________
44  ________________________________________________________________________________________________________________________________________________________________
45  ________________________________________________________________________________________________________________________________________________________________
46  ________________________________________________________________________________________________________________________________________________________________
47  ________________________________________________________________________________________________________________________________________________________________
48  ________________________________________________________________________________________________________________________________________________________________
49  ________________________________________________________________________________________________________________________________________________________________
50  ________________________________________________________________________________________________________________________________________________________________
51  ________________________________________________________________________________________________________________________________________________________________
52  ________________________________________________________________________________________________________________________________________________________________
53  ________________________________________________________________________________________________________________________________________________________________
54  ________________________________________________________________________________________________________________________________________________________________
55  ________________________________________________________________________________________________________________________________________________________________
56  ________________________________________________________________________________________________________________________________________________________________
57  ________________________________________________________________________________________________________________________________________________________________
58  ________________________________________________________________________________________________________________________________________________________________
59  ________________________________________________________________________________________________________________________________________________________________
60  ________________________________________________________________________________________________________________________________________________________________
61  ________________________________________________________________________________________________________________________________________________________________
62  ________________________________________________________________________________________________________________________________________________________________
63  ________________________________________________________________________________________________________________________________________________________________
64  ________________________________________________________________________________________________________________________________________________________________
65  ________________________________________________________________________________________________________________________________________________________________
66  ________________________________________________________________________________________________________________________________________________________________
67  ________________________________________________________________________________________________________________________________________________________________
68  ________________________________________________________________________________________________________________________________________________________________
69  ________________________________________________________________________________________________________________________________________________________________
70  ________________________________________________________________________________________________________________________________________________________________
71  ________________________________________________________________________________________________________________________________________________________________
72  ________________________________________________________________________________________________________________________________________________________________
73  ________________________________________________________________________________________________________________________________________________________________
74  ________________________________________________________________________________________________________________________________________________________________
75  ________________________________________________________________________________________________________________________________________________________________
76  ________________________________________________________________________________________________________________________________________________________________
77  ________________________________________________________________________________________________________________________________________________________________
78  ________________________________________________________________________________________________________________________________________________________________
79  ________________________________________________________________________________________________________________________________________________________________
80  ________________________________________________________________________________________________________________________________________________________________
81  ________________________________________________________________________________________________________________________________________________________________
82  ________________________________________________________________________________________________________________________________________________________________
83  ________________________________________________________________________________________________________________________________________________________________
84  ________________________________________________________________________________________________________________________________________________________________
85  ________________________________________________________________________________________________________________________________________________________________
86  ________________________________________________________________________________________________________________________________________________________________
87  ________________________________________________________________________________________________________________________________________________________________
88  ________________________________________________________________________________________________________________________________________________________________
89  ________________________________________________________________________________________________________________________________________________________________
90  ________________________________________________________________________________________________________________________________________________________________
91  ________________________________________________________________________________________________________________________________________________________________
92  ________________________________________________________________________________________________________________________________________________________________
93  ________________________________________________________________________________________________________________________________________________________________
94  __________________________________________________________________________________1_____________________________________________________________________________
95  __________________________________________________________________________________1_____________________________________________________________________________
96  __________________________________________________________________________________1_____________________________________________________________________________
97  __________________________________________________________________________________1_____________________________________________________________________________
98  __________________________________________________________________________________1_____________________________________________________________________________
99  __________________________________________________________________________________1_____________________________________________________________________________
100 __________________________________________________________________________________1_____________________________________________________________________________
101 __________________________________________________________________________________1_____________________________________________________________________________
102 ___________________________________________________________________11111111_______1_____________________________________________________________________________
103 ___________________________________________________________________1_______11_____1_____________________________________________________________________________
104 ___________________________________________________________________1_________11___1_____________________________________________________________________________
105 ___________________________________________________________________1___________11_1_____________________________________________________________________________
106 ___________________________________________________________________1_____________11_____________________________________________________________________________
107 ___________________________________________________________________1______________1_____________________________________________________________________________
108 ___________________________________________________________________1______________1_____________________________________________________________________________
109 ___________________________________________________________________1______________1_____________________________________________________________________________
110 ___________________________________________________________________1______________1__1111111111_________________________________________________________________
111 ___________________________________________________________________1______________111__________1111_____________________________________________________________
112 ___________________________________________________________________1_______________________________111__________________________________________________________
113 ___________________________________________________________________1__________________________________111_______________________________________________________
114 ___________________________________________________________________1_____________________________________1111___________________________________________________
115 ___________________________________________________________________1_________________________________________111___11___________________________________________
116 _________________________________________________________________111111_________________________________________111__1__________________________________________
117 _________________________________________________________________1_____11_____________________________________________111_______________________________________
118 _________________________________________________________________1_______111_____________________________________________1111___________________________________
119 _________________________________________________________________1__________111______________________________________________11111______________________________
120 ______________________________________________________111111111111_____________11_________________________________________________1111__________________________
121 ____________________________________1111111111111111__1__________________________111__________________________________________________111111____________________
122 ____________________________________1______________1___1____________________________11______________________________________________________111111______________
123 ____________________________________1_______________1_1_______________________________1133________________________________________________________111___________
124 ____________________________________1________________11_______________________________333333________________________________________________________1___________
125 ____________________________________1________________11___11111______________________333333333______________________________________________________1___________
126 ____________________________________1_________________1111_____111_________________3333333333333____________________________________________________1___________
127 ____________________________________1_____________________________111______________333333333333333________________________________________________1_1___________
128 ____________________________________1_____________________________1__111________33_333333333333333333_____________________________________1_______1_1___________
129 ____________________________________1_____________________________1_____11_____333_33333333333333333333___________________________________1_______1_1___________
130 ____________________________________1_____________________________1_______1__33333_3333333333333333333333_________________________________1_______1_1___________
131 ____________________________________1_____________________________11111111113333_3_333333333333333333333333_______________________________1_______1_1___________
132 ____________________________________11111111111______________________________3333__333333333333333333333333333____________________________1_______1_1___________
133 ____________________________________________11________________________________3333___333333333333333333333333333__________________________1_______1_1___________
134 __________________________________________11____________________________________33_33__333333333333333333333333333________________________1_______1_1___________
135 ________________________________________11________________________________________33333__3333333333333333333333333______________________111_______1_1___________
136 ________________________________________1___________________________________________33333__333333333333333333333_33_33________________11__1_______1_1___________
137 _________________________________________11___________________________________________33333_3333333333333333333_333_33_3___________111____1_______1_1___________
138 ___________________________________________11___________________________________________3333__3333333333333333_3333_33__33____11111_______1_______1_1___________
139 _____________________________________________11___________________________________________3333__3333333333333_33333_3___33_111____________1_______1_1___________
140 _____________________________________________1______________________________________________3333__3333333333_333333____33_1_______________1_______1_1___________
141 ____________________________________________1________________________________________________33333__3333333_333333___3_3__1_______________1_______1_1___________
142 ___________________________________________1___________________________________________________33333__3333_3333333__33____1_______________1_______1_1___________
143 __________________________________________1______________________________________________________33333__3_333333333_3_____1_______________1_______1_1___________
144 _________________________________________1_________________________________________________________33333_3333333333______1________________1_______1_1___________
145 __________________________________________11_________________________________________________________33333333333333_____1_________________1_______1_1___________
146 ____________________________________________11_________________________________________________________33333333333_____1__________________1_______1_1___________
147 ______________________________________________11_________________________________________________________33333333_____1___________________1_______1_1___________
148 ________________________________________________11_________________________________________________________3333______1____________________1_______1_1___________
149 __________________________________________________11_________________________________________________________3______1_____________________1_______1_1___________
150 ____________________________________________________11_____________________________________________________________1______________________1_______1_1___________
151 ______________________________________________________11__________________________________________________________1_______________________1_______1_1___________
152 ________________________________________________________11_______________________________________________________1________________________1_______1_1___________
153 __________________________________________________________11____________________________________________________1_________________________1_______1_1___________
154 ____________________________________________________________11_________________________________________________1__________________________1_______1_1___________
155 ______________________________________________________________1______________________________________________111__________________________1_______1_1___________
156 _______________________________________________________________11___________________________________________1__1__________________________1_______1_1___________
157 _________________________________________________________________11_______________________________________11___1__________________________1_______1_11__________
158 ___________________________________________________________________11____________________________________1_____1__________________________1___________111_______
159 _____________________________________________________________________11________________________________11______1__________________________1______________11_____
160 _______________________________________________________________________11_____________________________1________1__________________________1________________111__
161 _________________________________________________________________________11__________________________11________1__________________________1___________________11
162 ___________________________________________________________________________11_______________________1_1________1__________________________1_____________________
163 _____________________________________________________________________________11____________________1__1________1__________________________1_____________________
164 _______________________________________________________________________________11_________________1___1________1__________________________1_____________________
165 _________________________________________________________________________________11_____________11____1________1__________________________1_____________________
166 ___________________________________________________________________________________11_________111_____1________1__________________________1_____________________
167 _____________________________________________________________________________________111111111__1_____1________1__________________________1_____________________
