    0         10        20        30        40        50        60        70        80        90        100       110       120       130       140       150       
    0123456789012345678901234567890123456789012345678901234567890123456789012345678901234567890123456789012345678901234567890123456789012345678901234567890123456789
0   ________________________________________________________________________________________________________________________________________________________________
1   ___________________________________________________________________________________________________________________________________________________________11___
2   __________________________________________________________________________________________________________________________________________________________11____
3   _________________________________________________________________________________________________________________________________________________________11_____
4   ________________________________________________________________________________________________________________________________________________________11______
5   _______________________________________________________________________________________________________________________________________________________11_______
6   ______________________________________________________________________________________________________________________________________________________11________
7   _____________________________________________________________________________________________________________________________________________________11_________
8   ____________________________________________________________________________________________________________________________________________________11__________
9   ___________________________________________________________________________________________________________________________________________________11___________
10  __________________________________________________________________________________________________________________________________________________11____________
11  _________________________________________________________________________________________________________________________________________________11_____________
12  ________________________________________________________________________________________________________________________________________________11______________
13  _______________________________________________________________________________________________________________________________________________11___________333_
14  ______________________________________________________________________________________________________________________________________________11____________3332
15  _____________________________________________________________________________________________________________________________________________11_____________3321
16  ____________________________________________________________________________________________________________________________________________11______________321_
17  ___________________________________________________________________________________________________________________________________________11___________3333213_
18  __________________________________________________________________________________________________________________________________________11____________3332133_
19  _________________________________________________________________________________________________________________________________________11_____________3321333_
20  ________________________________________________________________________________________________________________________________________11______________3213333_
21  _______________________________________________________________________________________________________________________________________11___________33332133333_
22  ______________________________________________________________________________________________________________________________________11____________33321333333_
23  _____________________________________________________________________________________________________________________________________11_____________33213333333_
24  ____________________________________________________________________________________________________________________________________11______________32133333333_
25  ___________________________________________________________________________________________________________________________________11___________333321333333333_
26  __________________________________________________________________________________________________________________________________11____________333213333333333_
27  _________________________________________________________________________________________________________________________________11_____________332133333333333_
28  ________________________________________________________________________________________________________________________________11______________321333333333333_
29  _______________________________________________________________________________________________________________________________11___________3333213333333333333_
30  ______________________________________________________________________________________________________________________________11____________3332133333333333333_
31  _____________________________________________________________________________________________________________________________11_____________3321333333333333333_
32  ____________________________________________________________________________________________________________________________11______________3213333333333333333_
33  ___________________________________________________________________________________________________________________________11___________33332133333333333333333_
34  __________________________________________________________________________________________________________________________11____________33321333333333333333333_
35  _________________________________________________________________________________________________________________________11_____________3321333333333333333333__
36  ________________________________________________________________________________________________________________________11______________321333333333333333333___
37  _______________________________________________________________________________________________________________________11___________333321333333333333333333____
38  ______________________________________________________________________________________________________________________11____________333213333333333333333333____
39  _____________________________________________________________________________________________________________________11_____________33213333333333333333333_____
40  ____________________________________________________________________________________________________________________11______________3213333333333333333333______
41  ___________________________________________________________________________________________________________________11___________333321333333333333333333________
42  __________________________________________________________________________________________________________________11____________33321333333333333333333_________
43  _________________________________________________________________________________________________________________11_____________332133333333333333333___________
44  ________________________________________________________________________________________________________________11______________3213333333333333333_____________
45  _______________________________________________________________________________________________________________11___________3333213333333333____________________
46  ______________________________________________________________________________________________________________11____________33321333333333______________________
47  _____________________________________________________________________________________________________________11_____________332133333333________________________
48  ____________________________________________________________________________________________________________11______________3213333333__________________________
49  ___________________________________________________________________________________________________________11___________3333213333333___________________________
50  __________________________________________________________________________________________________________11____________333213333333____________________________
51  _________________________________________________________________________________________________________11_____________332133333333____________________________
52  ________________________________________________________________________________________________________11______________32133333333_____________________________
53  _______________________________________________________________________________________________________11___________13332133333333______________________________
54  ______________________________________________________________________________________________________11___________1__32133333333_______________________________
55  _____________________________________________________________________________________________________11___________1___21333333333_______________________________
56  ____________________________________________________________________________________________________11___________1___21_33333333________________________________
57  ___________________________________________________________________________________________________11___________1___21___333333_________________________________
58  __________________________________________________________________________________________________11___________1___21____3333___________________________________
59  _________________________________________________________________________________________________11____________1__21______3_____________________________________
60  ________________________________________________________________________________________________11____________1__21_____________________________________________
61  _______________________________________________________________________________________________11____________1__21______________________________________________
62  ______________________________________________________________________________________________11____________1__21_______________________________________________
63  _____________________________________________________________________________________________11____________1__21________________________________________________
64  ____________________________________________________________________________________________11__________331__21_________________________________________________
65  ___________________________________________________________________________________________11___________333_21__________________________________________________
66  __________________________________________________________________________________________11____________33321___________________________________________________
67  _________________________________________________________________________________________11_____________3321____________________________________________________
68  ________________________________________________________________________________________11__________3333321_____________________________________________________
69  _______________________________________________________________________________________11___________3333213_____________________________________________________
70  ______________________________________________________________________________________11____________3332133_____________________________________________________
71  _____________________________________________________________________________________11_____________3321333_____________________________________________________
72  ____________________________________________________________________________________11__________33333213333_____________________________________________________
73  ___________________________________________________________________________________11___________33332133333_____________________________________________________
74  __________________________________________________________________________________11____________33321333333_____________________________________________________
75  _________________________________________________________________________________11_____________3321333333______________________________________________________
76  ________________________________________________________________________________11__________33333213333333______________________________________________________
77  _______________________________________________________________________________11___________3333213333333_______________________________________________________
78  ______________________________________________________________________________11____________3332133333333_______________________________________________________
79  _____________________________________________________________________________11_____________332133333333________________________________________________________
80  ____________________________________________________________________________11__________333332133333333_________________________________________________________
81  ___________________________________________________________________________11___________33332133333333__________________________________________________________
82  __________________________________________________________________________11____________3332133333333___________________________________________________________
83  _________________________________________________________________________11_____________332133333333____________________________________________________________
84  ________________________________________________________________________11__________333332133333333_____________________________________________________________
85  _______________________________________________________________________11___________3333213333333_______________________________________________________________
86  ______________________________________________________________________11____________333213333333________________________________________________________________
87  _____________________________________________________________________11_____________332133333333________________________________________________________________
88  ____________________________________________________________________11__________333332133333333_________________________________________________________________
89  ___________________________________________________________________11___________333321333333333_________________________________________________________________
90  __________________________________________________________________11____________333213333333333_________________________________________________________________
91  _________________________________________________________________11_____________33213333333333__________________________________________________________________
92  ________________________________________________________________11__________33333213333333333___________________________________________________________________
93  _______________________________________________________________11___________33332133333333333___________________________________________________________________
94  ______________________________________________________________11____________3332133333333333____________________________________________________________________
95  _____________________________________________________________11_____________332133333333333_____________________________________________________________________
96  ____________________________________________________________11__________333332133333333333______________________________________________________________________
97  ___________________________________________________________11___________33332133333333333_______________________________________________________________________
98  __________________________________________________________11____________3332133333333333________________________________________________________________________
99  _________________________________________________________11_____________332133333333333_________________________________________________________________________
100 ________________________________________________________11__________333332133333333333__________________________________________________________________________
101 _______________________________________________________11___________3333213333333333____________________________________________________________________________
102 ______________________________________________________11____________33321333333333______________________________________________________________________________
103 _____________________________________________________11_____________33213333333_________________________________________________________________________________
104 ____________________________________________________11__________333332133333____________________________________________________________________________________
105 ___________________________________________________11___________3333213333______________________________________________________________________________________
106 __________________________________________________11____________333213333_______________________________________________________________________________________
107 _________________________________________________11_____________332133333_______________________________________________________________________________________
108 ________________________________________________11__________333332133333________________________________________________________________________________________
109 _______________________________________________11___________3333213333__________________________________________________________________________________________
110 ______________________________________________11____________333213333___________________________________________________________________________________________
111 _____________________________________________11__________1__332133333___________________________________________________________________________________________
112 ____________________________________________11__________1_3332133333____________________________________________________________________________________________
113 ___________________________________________11___________1_3321333333____________________________________________________________________________________________
114 __________________________________________11___________1__3213333333____________________________________________________________________________________________
115 _________________________________________11____________1__2133333333____________________________________________________________________________________________
116 ________________________________________11____________1__2133333333_____________________________________________________________________________________________
117 _______________________________________11_____________1_21_33333333_____________________________________________________________________________________________
118 ______________________________________11_____________1_21__33333333_____________________________________________________________________________________________
119 _____________________________________11______________121____3333333_____________________________________________________________________________________________
120 ____________________________________11___________333121______33333______________________________________________________________________________________________
121 ___________________________________11____________33321_______3333_______________________________________________________________________________________________
122 __________________________________11_____________3321___________________________________________________________________________________________________________
123 _________________________________11______________3213___________________________________________________________________________________________________________
124 ________________________________11___________33332133___________________________________________________________________________________________________________
125 _______________________________11____________33321333___________________________________________________________________________________________________________
126 ______________________________11_____________33213333___________________________________________________________________________________________________________
127 _____________________________11______________32133333___________________________________________________________________________________________________________
128 ____________________________11___________33332133333____________________________________________________________________________________________________________
129 ___________________________11____________33321333333____________________________________________________________________________________________________________
130 __________________________11_____________33213333333____________________________________________________________________________________________________________
131 _________________________11______________32133333333____________________________________________________________________________________________________________
132 ________________________11___________33332133333333_____________________________________________________________________________________________________________
133 _______________________11____________33321333333333_____________________________________________________________________________________________________________
134 ______________________11_____________3321_333333333_____________________________________________________________________________________________________________
135 _____________________11______________321___33333333_____________________________________________________________________________________________________________
136 ____________________11___________333321____33333333_____________________________________________________________________________________________________________
137 ___________________11____________333213_____333333______________________________________________________________________________________________________________
138 __________________11_____________33213_______33333______________________________________________________________________________________________________________
139 _________________11______________32133_______33333______________________________________________________________________________________________________________
140 ________________11___________33332133_________3333______________________________________________________________________________________________________________
141 _______________11____________33321333_________333_______________________________________________________________________________________________________________
142 ______________11_____________33213333_________333_______________________________________________________________________________________________________________
143 _____________11______________32133333__________33_______________________________________________________________________________________________________________
144 ____________11___________333321333333__________33_______________________________________________________________________________________________________________
145 ___________11____________333213333333__________3________________________________________________________________________________________________________________
146 __________11_____________3321333333_____________________________________________________________________________________________________________________________
147 _________11_________1____321333333______________________________________________________________________________________________________________________________
148 ________11_________1_3333213333333______________________________________________________________________________________________________________________________
149 _______11__________1_333213333333_______________________________________________________________________________________________________________________________
150 ______11__________1__332133333333_______________________________________________________________________________________________________________________________
151 _____11___________1__32133333333________________________________________________________________________________________________________________________________
152 ____11___________1___21333333333________________________________________________________________________________________________________________________________
153 ___11___________1___213333333333________________________________________________________________________________________________________________________________
154 __11____________1__21333333333__________________________________________________________________________________________________________________________________
155 _11____________1__21__3333______________________________________________________________________________________________________________________________________
156 11_______________21___333_______________________________________________________________________________________________________________________________________
157 ________________21____333_______________________________________________________________________________________________________________________________________
158 _______________21______3________________________________________________________________________________________________________________________________________
159 ______________21________________________________________________________________________________________________________________________________________________
160 ___________33213________________________________________________________________________________________________________________________________________________
161 ___________32133________________________________________________________________________________________________________________________________________________
162 ___________2133_________________________________________________________________________________________________________________________________________________
163 __________21333_________________________________________________________________________________________________________________________________________________
164 _______3321333__________________________________________________________________________________________________________________________________________________
165 _______321333___________________________________________________________________________________________________________________________________________________
166 _______21333____________________________________________________________________________________________________________________________________________________
167 ______21________________________________________________________________________________________________________________________________________________________
