    0         10        20        30        40        50        60        70        80        90        100       110       120       130       140       150       
    0123456789012345678901234567890123456789012345678901234567890123456789012345678901234567890123456789012345678901234567890123456789012345678901234567890123456789
0   ________________________________________________________________________________________________________________________________________________________________
1   ________________________________________________________________________________________________________________________________________________________________
2   ________________________________________________________________________________________________________________________________________________________________
3   ________________________________________________________________________________________________________________________________________________________________
4   ________________________________________________________________________________________________________________________________________________________________
5   ________________________________________________________________________________________________________________________________________________________________
6   ________________________________________________________________________________________________________________________________________________________________
7   ________________________________________________________________________________________________________________________________________________________________
8   ________________________________________________________________________________________________________________________________________________________________
9   ________________________________________________________________________________________________________________________________________________________________
10  ________________________________________________________________________________________________________________________________________________________________
11  ________________________________________________________________________________________________________________________________________________________________
12  ________________________________________________________________________________________________________________________________________________________________
13  ________________________________________________________________________________________________________________________________________________________________
14  ________________________________________________________________________________________________________________________________________________________________
15  ________________________________________________________________________________________________________________________________________________________________
16  ________________________________________________________________________________________________________________________________________________________________
17  ________________________________________________________________________________________________________________________________________________________________
18  ______________________________________________________________________________________________________________11111111111_______________________________________
19  _____________________________________________________________________________________________________________1_________1________________________________________
20  _____________________________________________________________________________________________________________1________1_________________________________________
21  ____________________________________________________________________________________________________________1________1__________________________________________
22  ____________________________________________________________________________________________________________1________1__________________________________________
23  ___________________________________________________________________________________________________________1________1___________________________________________
24  ___________________________________________________________________________________________________________1_______1____________________________________________
25  __________________________________________________________________________________________________________1_______1_____________________________________________
26  _________________________________________________________________________________________________________1_______1______________________________________________
27  _________________________________________________________________________________________________________1______1_______________________________________________
28  ________________________________________________________________________________________________________1_______1_______________________________________________
29  ________________________________________________________________________________________________________1______1________________________________________________
30  _______________________________________________________________________________________________________1______1_________________________________________________
31  _______________________________________________________________________________________________________1_____11_________________________________________________
32  ______________________________________________________________________________________________________1________111111_1111______________________________________
33  _____________________________________________________________________________________________________1___________1______________________________________________
34  _____________________________________________________________________________________________________1___________1______________________________________________
35  ____________________________________________________________________________________________________1___________1_______________________________________________
36  ____________________________________________________________________________________________________1___________1_______________________________________________
37  ___________________________________________________________________________________________________1____________1_______________________________________________
38  ___________________________________________________________________________________________________1____________1_______________________________________________
39  __________________________________________________________________________________________________1____________1________________________________________________
40  __________________________________________________________________________________________________1____________1________________________________________________
41  _________________________________________________________________________________________________1_____________1________________________________________________
42  _________________________________________________________________________________________________1_____________1________________________________________________
43  _________________________________________________________________________________________________1____________1_________________________________________________
44  _________________________________________________________________________________________________1____________1_________________________________________________
45  _________________________________________________________________________________________________1____________1_________________________________________________
46  _________________________________________________________________________________________________1____________1_________________________________________________
47  ________________________________________________________________________________________________1_____________1__________1______________________________________
48  ________________________________________________________________________________________________1____________1__________1_1_____________________________________
49  ________________________________________________________________________________________________1____________1__________1__1____________________________________
50  ________________________________________________________________________________________________1____________1_________1____1___________________________________
51  _______________________________________________________________________________________________1_____________1________1______1__________________________________
52  ______________________________________________________________________________________________1_____________1_________1_______1_________________________________
53  _____________________________________________________________________________________________1______________1________1_________1________________________________
54  ____________________________________________________________________________________________1______________1________1___________1_______________________________
55  ___________________________________________________________________________________________1_______________1________1___________1_______________________________
56  _____________________________________________________________________________________111111_______________1________1_____________1______________________________
57  _____________________________________________________________________________________1____________________1_______1_______________1_____________________________
58  _____________________________________________________________________________________1___________________1________1________________1____________________________
59  _____________________________________________________________________________________1________________11_________1__________________1___________________________
60  _____________________________________________________________________________________1_____________111___________1___________________1__________________________
61  _____________________________________________________________________________________1___________11_____________1_____________________1_________________________
62  _____________________________________________________________________________________1_________11_______________1____________________1__________________________
63  _____________________________________________________________________________________1________1________________1_____________________1__________________________
64  ____________________________________________________________________________________1_________1_______________1_____________________1___________________________
65  ____________________________________________________________________________________1________11_______________1_____________________1___________________________
66  ___________________________________________________________________________________1__________1______________1_____________________1____________________________
67  __________________________________________________________________________________1___________1______________1_____________________1____________________________
68  _________________________________________________________________________________1____________1_____________1_____________________1_____________________________
69  ________________________________________________________________________________1_____________1_____________1_____________________1_____________________________
70  ________________________________________________________________________11111111_____________11____________1_____________________1______________________________
71  _______________________________________________________________________1_____________________11____________1_____________________1______________________________
72  ______________________________________________________________________1_____________________1__1__________1_____________________1_______________________________
73  ______________________________________________________________________1_____________________1__1_________1______________________1_______________________________
74  ______________________________________________________________________1_____________________1__1_________1_____________________1________________________________
75  ___________________________________________________________________1111____________________1___1________1______________________1________________________________
76  ______________________________________________________________11111________________________1___1________1_____________________1_________________________________
77  ___________________________________________________________111_____________________________1___1_______1_____________________1__________________________________
78  ________________________________________________________111_______________________________1____1_______1_____________________1__________________________________
79  ______________________________________________________11__________________________________1____1___1111_____________________1___________________________________
80  _____________________________________________________1____________________________________1____1111_________________________1___________________________________
81  ____________________________________________________1____________________________________1_____1___________________________1____________________________________
82  ___________________________________________________1_____________________________________1____1____________________________1____________________________________
83  _____1111111111_________1111111111111111__________1_____________________________________1_____1___________________________1_____________________________________
84  _____1_________11_______1______________1_________1_____________________________________1_____1____________________________1_____________________________________
85  _____1___________11____11______________1_________1____________________________________1______1___________________________1______________________________________
86  _____1_____________1111________________1_________1___________________________________1_______1___________________________1______________________________________
87  _____1_________________________________1_________1___________________________________1______1___________________________1_______________________________________
88  _____1_________________________________1________1___________________________________1_______1___________________________1_______________________________________
89  _____1_________________________________1_______1___________________________________1_______1___________________________1________________________________________
90  ______11_______________________________111____1___________________________________1________1___________________________1________________________________________
91  ________11________________________________1111________________________________1111__________1_________________________1_________________________________________
92  __________11___________________________________________________________1111111_______________1________________________1_________________________________________
93  ____________1______________1111_________________________________1111111_______________________1_______________________1_________________________________________
94  ____________1____________11____1111_________________________1111_______________________________111111_________________1_________________________________________
95  ____________1__________11________111________________________1_____________1_________________________1_________________1_________________________________________
96  ______1111111________11___1111111___________________________11111111____11_11111111____________111111_________________111111111111111111111111111111111111111111
97  111111_______________11111__________________________________________1111__________1____________1________________________________________________________________
98  ___________________________________________________________________________________1___________1________________________________________________________________
99  ___________________________________________________________________________________1__________1_________________________________________________________________
100 ___________________________________________________________________________________1__________1_________________________________________________________________
101 ___________________________________________________________________________________1__________1_________________________________________________________________
102 ____________________________________________________________________________________1_________1_________________________________________________________________
103 ____________________________________________________________________________________1111111__1_____________________________________111111_______________________
104 _________________________________________________1111111___________________________________1_1_____________________________11111111_____1_______________________
105 _______________________________________________11_______11__________________________________1__________________________1111______________1______________________
106 ______________________________________________1___________11_______________________________________________________1111__________________1______________________
107 __________111111111111111111________________11______________11________1111111____________________________________11_____________________1_______________________
108 ________11__________________111____________11_________________11____11_______11__________________________________111___________111111111________________________
109 ________11111111___________1111______________11___________1111_______11______1______________________________________11111111111_________________________________
110 ________________11111111111____________________11111111111_____________111111________________________________________________11_________________________________
111 ___________________________________________________________________________________________________________________________11___________________________________
112 _________________________________________________________________________________________________________________________11_____________________________________
113 ______________________________________________________________________________________________________________________111_______________________________________
114 ____________________________________________________________________________________________________________________11__________________________________________
115 _______________________________________________________________________________________________________________11111____________________________________________
116 _______________________________________________________________________________________________________11111111_________________________________________________
117 _______________________________________________________________________________________________11111111_________________________________________________________
118 _____________________________________________111111111111111______________________________11111_________________________________________________________________
119 __________________________________11111111111_______________11111______________________111______________________________________________________________________
120 __________________________________111111_____________111111111111___________________111_________________________________________________________________________
121 ________________________________________1111111111111____________________________111____________________________________________________________________________
122 _______________________________________________________________________________11_______________________________________________________________________________
123 _______________________________________________________________________________1________________________________________________________________________________
124 ______________________________________________________________________________1_________________________________________________________________________________
125 ______________________________________________________________________________1_________________________________________________________________________________
126 _____________________________________________________________________________1__________________________________________________________________________________
127 _____________________________________________________________________________1__________________________________________________________________________________
128 ______________________________________________________________________________11________________________________________________________________________________
129 ______________________________________________________________11111_____________11______________________________________________________________________________
130 ____________________________1111_________________________11111_____1111___________1_____________________________________________________________________________
131 _________________________111____11____________________111______________11__________11___________________________________________________________________________
132 _________________________111____11____________________1_________111111111____________11_________________________________________________________________________
133 ____________________________1111______________________1_________1______________________11_______________________________________________________________________
134 ______________________________________________________1_________1________________________1______________________________________________________________________
135 ______________________________________________________1_________1_________________________1_____________________________________________________________________
136 ______________________________________________________1_________1__________________________1____________________________________________________________________
137 ______________________________________________________1_________1___________________________1___________________________________________________________________
138 ______________________________________________________1_________1_________1111111__111111111____________________________________________________________________
139 ______________________________________________________11111111111_______11111111111_____________________________________________________________________________
140 ______________________________________________________________________11__1_____________________________________________________________________________________
141 _____________________________________________________________________1____1_____________________________________________________________________________________
142 _____________________________________________________________________1____1111111111____________________________________________________________________________
143 ________________________________________________1111_________________1111111111____1____________________________________________________________________________
144 _______________________________________________11___11____________________________1_____________________________________________________________________________
145 _________________________________________________111______________________________1_____________________________________________________________________________
146 _________________________________________________________________________________1______________________________________________________________________________
147 _________________________________________________________________________________1______________________________________________________________________________
148 ________________________________________________________________________________1_______________________________________________________________________________
149 ________________________________________________________________________________1_______________________________________________________________________________
150 ______________________111______________________________________________________1________________________________________________________________________________
151 ________________111111___11__________________________________________________11_________________________________________________________________________________
152 __________111111___________11______________________________________________11___________________________________________________________________________________
153 ____111111___________________11__________________________________________11_____________________________________________________________________________________
154 1111___________________________1_________________1111_________________111_______________________________________________________________________________________
155 ________________________________11__________11111____11____________111__________________________________________________________________________________________
156 __________________________________11_____111___________11111_____11_____________________________________________________________________________________________
157 ____________________________________11_11___________________11111_______________________________________________________________________________________________
158 ______________________________________1_________________________________________________________________________________________________________________________
159 ________________________________________________________________________________________________________________________________________________________________
160 ________________________________________________________________________________________________________________________________________________________________
161 ________________________________________________________________________________________________________________________________________________________________
162 ________________________________________________________________________________________________________________________________________________________________
163 ________________________________________________________________________________________________________________________________________________________________
164 ________________________________________________________________________________________________________________________________________________________________
165 ________________________________________________________________________________________________________________________________________________________________
166 ________________________________________________________________________________________________________________________________________________________________
167 ________________________________________________________________________________________________________________________________________________________________
