    0         10        20        30        40        50        60        70        80        90        100       110       120       130       140       150       
    0123456789012345678901234567890123456789012345678901234567890123456789012345678901234567890123456789012345678901234567890123456789012345678901234567890123456789
0   ________________________________________________________________________________________________________________________________________________________________
1   ________________________________________________________________________________________________________________________________________________________________
2   ________________________________________________________________________________________________________________________________________________________________
3   ________________________________________________________________________________________________________________________________________________________________
4   ________________________________________________________________________________________________________________________________________________________________
5   ________________________________________________________________________________________________________________________________________________________________
6   ________________________________________________________________________________________________________________________________________________________________
7   ________________________________________________________________________________________________________________________________________________________________
8   ________________________________________________________________________________________________________________________________________________________________
9   ________________________________________________________________________________________________________________________________________________________________
10  ________________________________________________________________________________________________________________________________________________________________
11  ________________________________________________________________________________________________________________________________________________________________
12  ________________________________________________________________________________________________________________________________________________________________
13  ________________________________________________________________________________________________________________________________________________________________
14  ________________________________________________________________________________________________________________________________________________________________
15  ________________________________________________________________________________________________________________________________________________________________
16  ________________________________________________________________________________________________________________________________________________________________
17  ________________________________________________________________________________________________________________________________________________________________
18  ________________________________________________________________________________________________________________________________________________________________
19  ________________________________________________________________________________________________________________________________________________________________
20  ________________________________________________________________________________________________________________________________________________________________
21  ________________________________________________________________________________________________________________________________________________________________
22  ________________________________________________________________________________________________________________________________________________________________
23  ________________________________________________________________________________________________________________________________________________________________
24  ________________________________________________________________________________________________________________________________________________________________
25  ________________________________________________________________________________________________________________________________________________________________
26  ________________________________________________________________________________________________________________________________________________________________
27  ________________________________________________________________________________________________________________________________________________________________
28  ________________________________________________________________________________________________________________________________________________________________
29  ________________________________________________________________________________________________________________________________________________________________
30  ________________________________________________________________________________________________________________________________________________________________
31  ________________________________________________________________________________________________________________________________________________________________
32  ________________________________________________________________________________________________________________________________________________________________
33  ________________________________________________________________________________________________________________________________________________________________
34  ________________________________________________________________________________________________________________________________________________________________
35  ________________________________________________________________________________________________________________________________________________________________
36  ________________________________________________________________________________________________________________________________________________________________
37  ________________________________________________________________________________________________________________________________________________________________
38  ________________________________________________________________________________________________________________________________________________________________
39  ________________________________________________________________________________________________________________________________________________________________
40  ________________________________________________________________________________________________________________________________________________________________
41  ________________________________________________________________________________________________________________________________________________________________
42  ________________________________________________________________________________________________________________________________________________________________
43  ________________________________________________________________________________________________________________________________________________________________
44  ________________________________________________________________________________________________________________________________________________________________
45  3333333333333333333333333333333333333333333333333333333333333333333333333333333333333333333333333333333333333333333333333333333333333333333333333333333333333333
46  3333333333333333333333333333333333333333333333333333333333333333333333333333333333333333333333333333333333333333333333333333333333333333333333333333333333333333
47  3333333333333333333333333333333333333333333333333333333333333333333333333333333333333333333333333333333333333333333333333333333333333333333333333333333333333333
48  3333333333333333333333333333333333333333333333333333333333333333333333333333333333333333333333333333333333333333333333333333333333333333333333333333333333333333
49  3333333333333333333333333333333333333333333333333333333333333333333333333333333333333333333333333333333333333333333333333333333333333333333333333333333333333333
50  3333333333333333333333333333333333333333333333333333333333333333333333333333333333333333333333333333333333333333333333333333333333333333333333333333333333333333
51  3333333333333333333333333333333333333333333333333333333333333333333333333333333333333333333333333333333333333333333333333333333333333333333333333333333333333333
52  3333333333333333333333333333333333333333333333333333333333333333333333333333333333333333333333333333333333333333333333333333333333333333333333333333333333333333
53  3333333333333333333333333333333333333333333333333333333333333333333333333333333333333333333333333333333333333333333333333333333333333333333333333333333333333333
54  3333333333333333333333333333333333333333333333333333333333333333333333333333333333333333333333333333333333333333333333333333333333333333333333333333333333333333
55  3333333333333333333333333333333333333333333333333333333333333333333333333333333333333333333333333333333333333333333333333333333333333333333333333333333333333333
56  3333333333333333333333333333333333333333333333333333333333333333333333333333333333333333333333333333333333333333333333333333333333333333333333333333333333333333
57  3333333333333333333333333333333333333333333333333333333333333333333333333333333333333333333333333333333333333333333333333333333333333333333333333333333333333333
58  3333333333333333333333333333333333333333333333333333333333333333333333333333333333333333333333333333333333333333333333333333333333333333333333333333333333333333
59  3333333333333333333333333333333333333333333333333333333333333333333333333333333333333333333333333333333333333333333333333333333333333333333333333333333333333333
60  3333333333333333333333333333333333333333333333333333333333333333333333333333333333333333333333333333333333333333333333333333333333333333333333333333333333333333
61  3333333333333333333333333333333333333333333333333333333333333333333333333333333333333333333333333333333333333333333333333333333333333333333333333333333333333333
62  3333333333333333333333333333333333333333333333333333333333333333333333333333333333333333333333333333333333333333333333333333333333333333333333333333333333333333
63  3333333333333333333333333333333333333333333333333333333333333333333333333333333333333333333333333333333333333333333333333333333333333333333333333333333333333333
64  3333333333333333333333333333333333333333333333333333333333333333333333333333333333333333333333333333333333333333333333333333333333333333333333333333333333333333
65  3333333333333333333333333333333333333333333333333333333333333333333333333333333333333333333333333333333333333333333333333333333333333333333333333333333333333333
66  3333333333333333333333333333333333333333333333333333333333333333333333333333333333333333333333333333333333333333333333333333333333333333333333333333333333333333
67  3333333333333333333333333333333333333333333333333333333333333333333333333333333333333333333333333333333333333333333333333333333333333333333333333333333333333333
68  3333333333333333333333333333333333333333333333333333333333333333333333333333333333333333333333333333333333333333333333333333333333333333333333333333333333333333
69  3333333333333333333333333333333333333333333333333333333333333333333333333333333333333333333333333333333333333333333333333333333333333333333333333333333333333333
70  3333333333333333333333333333333333333333333333333333333333333333333333333333333333333333333333333333333333333333333333333333333333333333333333333333333333333333
71  3333333333333333333333333333333333333333333333333333333333333333333333333333333333333333333333333333333333333333333333333333333333333333333333333333333333333333
72  3333333333333333333333333333333333333333333333333333333333333333333333333333333333333333333333333333333333333333333333333333333333333333333333333333333333333333
73  33333333333333333333333333333333333333333333333333333333333333333333333_____333333333333333333333333333333333333333333333333333333333333333333333333333333333333
74  3333333333333333333333333333333333333333333333333333333333333333333333________3333333333333333333333333333333333333333333333333333333333333333333333333333333333
75  333333333333333333333333333333333333333333333333333333333333333333333___________3333333333333333333333333_____3333333333333333333333333333333____333333333333333
76  3333333333_____3333333333333333333333333333____333333333333333333333_____________33333333333333333333333_________33333333333333333333333333________3333333333333
77  333333333________33333333333333333333333_________3333333333333333333_____________3333333333333333333333____________33333333333333333333333___________33333333333
78  33333333___________33333333333333333333___________333333333333333333_____________333333333333333333333_____________3333333333333333333333____________33333333333
79  3333333_____________333333333333333333____________333333333333333333_____________333333333333333333333_____________3333333333333333333333____________33333333333
80  3333333_____________333333333333333333____________333333333333333333_____________333333333333333333333_____________3333333333333333333333____________33333333333
81  3333333_____________333333333333333333____________333333333333333333_____________333333333333333333333_____________3333333333333333333333____________33333333333
82  3333333_____________33333333333333333_____________333333333333333333_____________333333333333333333333_____________3333333333333333333333____________33333333333
83  3333333_____________33333333333333333_____________333333333333333333_____________333333333333333333333_____________3333333333333333333333____________33333333333
84  2222222222222222222222222222222222222222222222222222222222222222222222222222222222222222222222222222222222222222222222222222222222222222222222222222222222222222
85  _______1111111111111_________________1111111111111__________________1111111111111_____________________1111111111111______________________111111111111___________
86  ________________________________________________________________________________________________________________________________________________________________
87  ________________________________________________________________________________________________________________________________________________________________
88  ________________________________________________________________________________________________________________________________________________________________
89  ________________________________________________________________________________________________________________________________________________________________
90  ________________________________________________________________________________________________________________________________________________________________
91  ________________________________________________________________________________________________________________________________________________________________
92  ________________________________________________________________________________________________________________________________________________________________
93  ________________________________________________________________________________________________________________________________________________________________
94  ________________________________________________________________________________________________________________________________________________________________
95  ________________________________________________________________________________________________________________________________________________________________
96  ________________________________________________________________________________________________________________________________________________________________
97  ________________________________________________________________________________________________________________________________________________________________
98  ________________________________________________________________________________________________________________________________________________________________
99  ________________________________________________________________________________________________________________________________________________________________
100 ________________________________________________________________________________________________________________________________________________________________
101 ________________________________________________________________________________________________________________________________________________________________
102 ________________________________________________________________________________________________________________________________________________________________
103 ________________________________________________________________________________________________________________________________________________________________
104 ________________________________________________________________________________________________________________________________________________________________
105 ________________________________________________________________________________________________________________________________________________________________
106 ________________________________________________________________________________________________________________________________________________________________
107 ________________________________________________________________________________________________________________________________________________________________
108 ________________________________________________________________________________________________________________________________________________________________
109 ________________________________________________________________________________________________________________________________________________________________
110 ________________________________________________________________________________________________________________________________________________________________
111 ________________________________________________________________________________________________________________________________________________________________
112 ________________________________________________________________________________________________________________________________________________________________
113 ________________________________________________________________________________________________________________________________________________________________
114 ________________________________________________________________________________________________________________________________________________________________
115 ________________________________________________________________________________________________________________________________________________________________
116 ________________________________________________________________________________________________________________________________________________________________
117 ________________________________________________________________________________________________________________________________________________________________
118 1111111111__________________1111111111111111_________________________111111111111111______________________________1111111111111111______________________________
119 2222222222222222222222222222222222222222222222222222222222222222222222222222222222222222222222222222222222222222222222222222222222222222222222222222222222222222
120 ________________________________________________________________________________________________________________________________________________________________
121 ________________________________________________________________________________________________________________________________________________________________
122 ________________________________________________________________________________________________________________________________________________________________
123 ________________________________________________________________________________________________________________________________________________________________
124 ____________________3333333_______________________333333333333333333_________________33333333333333333____________________________3333333____________33333333333
125 ____________________3333333_______________________333333333333333333_________________33333333333333333_____________________________333333____________33333333333
126 ____________________3333333_______________________33333333333333333__________________33333333333333333_____________________________333333____________33333333333
127 ____________________3333333_______________________33333333333333333_________________333333333333333333____________________________3333333____________33333333333
128 ____________________33333333______________________33333333333333333_________________333333333333333333____________________________3333333____________33333333333
129 ____________________33333333______________________333333333333333333________________333333333333333333_____________________________333333____________33333333333
130 ____________________3333333_______________________333333333333333333_________________33333333333333333_____________________________333333____________33333333333
131 ____________________3333333_______________________33333333333333333__________________33333333333333333_____________________________333333____________33333333333
132 ____________________3333333_______________________33333333333333333__________________33333333333333333____________________________3333333____________33333333333
133 ____________________3333333_______________________33333333333333333_________________333333333333333333____________________________3333333____________33333333333
134 ____________________3333333_______________________33333333333333333_________________333333333333333333____________________________3333333____________33333333333
135 ____________________33333333______________________33333333333333333_________________333333333333333333___________________________33333333____________33333333333
136 ____________________33333333______________________333333333333333333________________333333333333333333___________________________33333333____________33333333333
137 ____________________33333333______________________333333333333333333________________333333333333333333___________________________33333333____________33333333333
138 ____________________33333333______________________333333333333333333________________333333333333333333___________________________33333333____________33333333333
139 ____________________33333333______________________333333333333333333________________333333333333333333___________________________33333333____________33333333333
140 _______111__________33333333______________________333333333333333333________________333333333333333333___________________________33333333____________33333333333
141 _______1__11111_____33333333______________________333333333333333333________________333333333333333333_____11111_________________33333333____________33333333333
142 _______1__1___1111__33333333________________111___3333333333333333331___________1___333333333333333333__111_____111______________33333333_____1111___33333333333
143 _______1__1___1___1133333333_____________111___1113333333333333333331111111111111___33333333333333333311__________1______________3333333311111____11_33333333333
144 _______11_11111__11333333333___________11______1133333333333333333333_______________3333333333333333331___________1______________33333333311_______1333333333333
145 _________111___1133333333333_____________11__11_333333333333333333333_______________333333333333333333311_______111______________3333333333311__1113333333333333
146 __________3_1133333333333333_______________11_33333333333333333333333_______________33333333333333333333_11__11133_______________333333333333311_333333333333333
147 __________333333333333333333________________3333333333333333333333333_______________3333333333333333333333311_3333_______________3333333333333333333333333333333
148 __________333333333333333333________________3333333333333333333333333_______________333333333333333333333333333333_______________3333333333333333333333333333333
149 __________333333333333333333________________3333333333333333333333333_______________333333333333333333333333333333_______________3333333333333333333333333333333
150 __________333333333333333333________________3333333333333333333333333_______________333333333333333333333333333333_______________3333333333333333333333333333333
151 __________333333333333333333________________3333333333333333333333333_______________333333333333333333333333333333_______________3333333333333333333333333333333
152 __________333333333333333333________________3333333333333333333333333_______________333333333333333333333333333333______________33333333333333333333333333333333
153 __________333333333333333333________________3333333333333333333333333_______________33333333333333333333333333333_______________33333333333333333333333333333333
154 __________333333333333333333________________3333333333333333333333333_______________33333333333333333333333333333_______________33333333333333333333333333333333
155 __________333333333333333333________________3333333333333333333333333_______________33333333333333333333333333333_______________33333333333333333333333333333333
156 __________333333333333333333________________3333333333333333333333333_______________33333333333333333333333333333_______________33333333333333333333333333333333
157 __________333333333333333333________________3333333333333333333333333_______________33333333333333333333333333333_______________33333333333333333333333333333333
158 __________333333333333333333________________3333333333333333333333333_______________33333333333333333333333333333_______________33333333333333333333333333333333
159 __________333333333333333333________________3333333333333333333333333_______________33333333333333333333333333333_______________33333333333333333333333333333333
160 __________333333333333333333________________3333333333333333333333333_______________33333333333333333333333333333_______________33333333333333333333333333333333
161 __________333333333333333333________________3333333333333333333333333_______________33333333333333333333333333333_______________33333333333333333333333333333333
162 __________333333333333333333________________3333333333333333333333333_______________33333333333333333333333333333_______________33333333333333333333333333333333
163 __________333333333333333333________________3333333333333333333333333_______________33333333333333333333333333333_______________33333333333333333333333333333333
164 __________333333333333333333________________3333333333333333333333333_______________33333333333333333333333333333_______________33333333333333333333333333333333
165 __________333333333333333333____111111111___3333333333333333333333333___11111111____33333333333333333333333333333_____11111111__33333333333333333333333333333333
166 ___11111__333333333333333333__11_11111___11_3333333333333333333333333_11___1111_11__33333333333333333333333333333__11111111___1_33333333333333333333333333333333
167 1111111_1133333333333333333311___1___111111133333333333333333333333331111111__1___113333333333333333333333333333311___1___1111_133333333333333333333333333333333
