    0         10        20        30        40        50        60        70        80        90        100       110       120       130       140       150       
    0123456789012345678901234567890123456789012345678901234567890123456789012345678901234567890123456789012345678901234567890123456789012345678901234567890123456789
0   ________________________________________________________________________________________________________________________________________________________________
1   ________________________________________________________________________________________________________________________________________________________________
2   ________________________________________________________________________________________________________________________________________________________________
3   ________________________________________________________________________________________________________________________________________________________________
4   ________________________________________________________________________________________________________________________________________________________________
5   ________________________________________________________________________________________________________________________________________________________________
6   ________________________________________________________________________________________________________________________________________________________________
7   ________________________________________________________________________________________________________________________________________________________________
8   ________________________________________________________________________________________________________________________________________________________________
9   ________________________________________________________________________________________________________________________________________________________________
10  ________________________________________________________________________________________________________________________________________________________________
11  ________________________________________________________________________________________________________________________________________________________________
12  ________________________________________________________________________________________________________________________________________________________________
13  ________________________________________________________________________________________________________________________________________________________________
14  ________________________________________________________________________________________________________________________________________________________________
15  ________________________________________________________________________________________________________________________________________________________________
16  ________________________________________________________________________________________________________________________________________________________________
17  ________________________________________________________________________________________________________________________________________________________________
18  ________________________________________________________________________________________________________________________________________________________________
19  ________________________________________________________________________________________________________________________________________________________________
20  ________________________________________________________________________________________________________________________________________________________________
21  ________________________________________________________________________________________________________________________________________________________________
22  ________________________________________________________________________________________________________________________________________________________________
23  ________________________________________________________________________________________________________________________________________________________________
24  ________________________________________________________________________________________________________________________________________________________________
25  ________________________________________________________________________________________________________________________________________________________________
26  ________________________________________________________________________________________________________________________________________________________________
27  ________________________________________________________________________________________________________________________________________________________________
28  ________________________________________________________________________________________________________________________________________________________________
29  ________________________________________________________________________________________________________________________________________________________________
30  ________________________________________________________________________________________________________________________________________________________________
31  ________________________________________________________________________________________________________________________________________________________________
32  ________________________________________________________________________________________________________________________________________________________________
33  ________________________________________________________________________________________________________________________________________________________________
34  ________________________________________________________________________________________________________________________________________________________________
35  ________________________________________________________________________________________________________________________________________________________________
36  ________________________________________________________________________________________________________________________________________________________________
37  ________________________________________________________________________________________________________________________________________________________________
38  ________________________________________________________________________________________________________________________________________________________________
39  ________________________________________________________________________________________________________________________________________________________________
40  ________________________________________________________________________________________________________________________________________________________________
41  ________________________________________________________________________________________________________________________________________________________________
42  ________________________________________________________________________________________________________________________________________________________________
43  ________________________________________________________________________________________________________________________________________________________________
44  ________________________________________________________________________________________________________________________________________________________________
45  ________________________________________________________________________________________________________________________________________________________________
46  ________________________________________________________________________________________________________________________________________________________________
47  ________________________________________________________________________________________________________________________________________________________________
48  ________________________________________________________________________________________________________________________________________________________________
49  ________________________________________________________________________________________________________________________________________________________________
50  ________________________________________________________________________________________________________________________________________________________________
51  ________________________________________________________________________________________________________________________________________________________________
52  ________________________________________________________________________________________________________________________________________________________________
53  ________________________________________________________________________________________________________________________________________________________________
54  ________________________________________________________________________________________________________________________________________________________________
55  ________________________________________________________________________________________________________________________________________________________________
56  ________________________________________________________________________________________________________________________________________________________________
57  ________________________________________________________________________________________________________________________________________________________________
58  ________________________________________________________________________________________________________________________________________________________________
59  ________________________________________________________________________________________________________________________________________________________________
60  ________________________________________________________________________________________________________________________________________________________________
61  ________________________________________________________________________________________________________________________________________________________________
62  ________________________________________________________________________________________________________________________________________________________________
63  ________________________________________________________________________________________________________________________________________________________________
64  ________________________________________________________________________________________________________________________________________________________________
65  ________________________________________________________________________________________________________________________________________________________________
66  ________________________________________________________________________________________________________________________________________________________________
67  ________________________________________________________________________________________________________________________________________________________________
68  ________________________________________________________________________________________________________________________________________________________________
69  ________________________________________________________________________________________________________________________________________________________________
70  ________________________________________________________________________________________________________________________________________________________________
71  ________________________________________________________________________________________________________________________________________________________________
72  ________________________________________________________________________________________________________________________________________________________________
73  ________________________________________________________________________________________________________________________________________________________________
74  ________________________________________________________________________________________________________________________________________________________________
75  ________________________________________________________________________________________________________________________________________________________________
76  ________________________________________________________________________________________________________________________________________________________________
77  ________________________________________________________________________________________________________________________________________________________________
78  ________________________________________________________________________________________________________________________________________________________________
79  ________________________________________________________________________________________________________________________________________________________________
80  ________________________________________________________________________________________________________________________________________________________________
81  ________________________________________________________________________________________________________________________________________________________________
82  ________________________________________________________________________________________________________________________________________________________________
83  ________________________________________________________________________________________________________________________________________________________________
84  ________________________________________________________________________________________________________________________________________________________________
85  ________________________________________________________________________________________________________________________________________________________________
86  ________________________________________________________________________________________________________________________________________________________________
87  ________________________________________________________________________________________________________________________________________________________________
88  ________________________________________________________________________________________________________________________________________________________________
89  ________________________________________________________________________________________________________________________________________________________________
90  ________________________________________________________________________________________________________________________________________________________________
91  ________________________________________________________________________________________________________________________________________________________________
92  ________________________________________________________________________________________________________________________________________________________________
93  ________________________________________________________________________________________________________________________________________________________________
94  ________________________________________________________________________________________________________________________________________________________________
95  ________________________________________________________________________________________________________________________________________________________________
96  ________________________________________________________________________________________________________________________________________________________________
97  ________________________________________________________________________________________________________________________________________________________________
98  ________________________________________________________________________________________________________________________________________________________________
99  ________________________________________________________________________________________________________________________________________________________________
100 ________________________________________________________________________________________________________________________________________________________________
101 ________________________________________________________________________________________________________________________________________________________________
102 ________________________________________________________________________________________________________________________________________________________________
103 ________________________________________________________________________________________________________________________________________________________________
104 ________________________________________________________________________________________________________________________________________________________________
105 ________________________________________________________________________________________________________________________________________________________________
106 ________________________________________________________________________________________________________________________________________________________________
107 ________________________________________________________________________________________________________________________________________________________________
108 ________________________________________________________________________________________________________________________________________________________________
109 ________________________________________________________________________________________________________________________________________________________________
110 ________________________________________________________________________________________________________________________________________________________________
111 ________________________________________________________________________________________________________________________________________________________________
112 ________________________________________________________________________________________________________________________________________________________________
113 ________________________________________________________________________________________________________________________________________________________________
114 ________________________________________________________________________________________________________________________________________________________________
115 ________________________________________________________________________________________________________________________________________________________________
116 ________________________________________________________________________________________________________________________________________________________________
117 ________________________________________________________________________________________________________________________________________________________________
118 ________________________________________________________________________________________________________________________________________________________________
119 ________________________________________________________________________________________________________________________________________________________________
120 _______________________________11111___11111___11111___11111___1___1____________________________________________________________________________________________
121 _______________________________1___1___1___1___1___1___1___1___1___1____________________________________________________________________________________________
122 _______________________________1___1___1___1___1___1___1___1___1___1____111_______111111____111111______________________________________________________________
123 _______________________________1___1___1___1___1___1___1___1___1___1____1_1_______1____1____1____1______________________________________________________________
124 _______________________________1___1___1___1___1___1___1___1___1___1____1_1_______1____1____1____1______________________________________________________________
125 _______________________________1___1___1___1___1___1___1___1___1___1____1_1_______1____1____1____1___1111111111111111111111111111_______________________________
126 _______________________________1___1___1___1___1___1___1___1___1___1____1_1_______1____1____1____1____1____1111_________________________________________________
127 _______________________________1___1___1___1___1___1___1___1___1___1____1_1_______1____1____1____1____1_______1_________________________________________________
128 _______________________________1___1___1___1___1___1___1___11111___11111111111111111111111111111111111111111__1_________________________________________________
129 _______________________________1___1___1___1___1___1___1__111111111_________________________________________1_111111____________________________________________
130 _______________________________1___1___1___1___1___1___1__1__________________________________________________1_____1___11111111111111111111111111111111111111111
131 _______________________________1___1___1___11111___11111_1____________________________________________________1____1___11______1____1_______1_______1______1___1
132 _______________________________1___1___1_1111111111111___1_____________________________________________________11__111111______1____1_______1_______1______1___1
133 _______________________________1___1___1_1___________1__1________________________________________________________1_____1_______1____1_______1_______1______1___1
134 _______________________________1___111111____________1111_________________________________________________________1____1_______1____1_______1_______1______1___1
135 _______________________________1_11111111__________________________________________________________________________111111111111111111111111111111111111111111111
136 _______________________________11_______________________________________________________________________________________________________________________________
137 _______________________________1________________________________________________________________________________________________________________________________
138 ______________________________1_________________________________________________________________________________________________________________________________
139 _______________________1_1___1__________________________________________________________________________________________________________________________________
140 _______________________1_1___1__________________________________________________________________________________________________________________________________
141 _______________________1__1__1__________________________________________________11111________________________________________________111111111111_______________
142 _______________________1__1__1_____________________________________________11111_____111_____________________________________________1________1__11111__________
143 _______________________11111__1____________________________________________111______1111_____________________________________________111111___1______1111_______
144 __________________________11__1_______________________________________________111111__________________111111111111111111___________________1111111111___________
145 __________________________1_1_1_______________________________________________________________________1_____1____1___1__1_______________________________________
146 __________________________1_1__11______________________________________________________________________1____1____1___1___1______________________________________
147 __________________________1111___1___________1111______________________________________________________1____1____1___1____1_______________________1111__________
148 ___________________________1_111__111_______1___1_________________________________111___________________1___1____1___1____1________________________1__11________
149 ___________________________1_1__1____1111___1__1__________________________________1__11_________________1___11111111_11111_1________________________1___1_______
150 ___________________________1_1___11111___111___111111111111111111_________________1____1111111111111111111_____1___1_____1__1_____________111111111111___1111111
151 ___________________________1_111111111111111111111111____________111111111111111111111111111111111111111111111_1___1111111___1111111111111111111111111111____1__
152 ___________________________1________1________1_______11111111111111111111111111111___________1111111_______1__1111111111111111111111111__111111____1____1____1__
153 ___________________________1___111111111_____1_____1111111111111111111_____1111111111111_____1_____1_______1____1____111111____1____1____1____1____1____1____1__
154 ___________________________1___1____1__1_____1_____1_____1_____1_____1_____1____1______1_____1_____1_______1____1____1____1____1____1____1____1____1____1____1__
155 ___________________________1___1____1__1_____1_____1_____1_____1_____1_____1____1______1_____1_____1_______1____1____1____1____1____1____1____1____1____1____1__
156 ___________________________1___1____1__1_____1_____1_____1_____1_____1_____1____1______1_____1_____1_______1____1____1____1____1____111111____111111____111111__
157 ___________________________1111111111__1_____1_____1_____1_____1_____1_____1____1______1_____1_____1_______1____111111____111111________________________________
158 _______________________________1_______1_____1_____1_____1_____1_____111111111111______1111111_____111111111____________________________________________________
159 _______________________________1_______1_____1111111111111_____1___________1____________________________________________________________________________________
160 _______________________________1_______1___________1___________1___________1____________________________________________________________________________________
161 _______________________________1_______1___________1___________1___________1____________________________________________________________________________________
162 _______________________________1_______1___________1___________1___________1____________________________________________________________________________________
163 _______________________________________1___________1___________1___________1____________________________________________________________________________________
164 _______________________________________1___________1___________1___________1____________________________________________________________________________________
165 _______________________________________1111111111111___________1111111111111____________________________________________________________________________________
166 ________________________________________________________________________________________________________________________________________________________________
167 ________________________________________________________________________________________________________________________________________________________________
