    0         10        20        30        40        50        60        70        80        90        100       110       120       130       140       150
    0123456789012345678901234567890123456789012345678901234567890123456789012345678901234567890123456789012345678901234567890123456789012345678901234567890123456789
0   ________________________________________________________________________________________________________________________________________________________________
1   ________________________________________________________________________________________________________________________________________________________________
2   ________________________________________________________________________________________________________________________________________________________________
3   ________________________________________________________________________________________________________________________________________________________________
4   ________________________________________________________________________________________________________________________________________________________________
5   ________________________________________________________________________________________________________________________________________________________________
6   ________________________________________________________________________________________________________________________________________________________________
7   ________________________________________________________________________________________________________________________________________________________________
8   ________________________________________________________________________________________________________________________________________________________________
9   ________________________________________________________________________________________________________________________________________________________________
10  ________________________________________________________________________________________________________________________________________________________________
11  _________________________________________1______________________________________________________________________________________________________________________
12  ________________________________________1_______________________________________________________________________________________________________________________
13  _______________________________________1________________________________________________________________________________________________________________________
14  _______________________________________1________________________________________________________________________________________________________________________
15  ______________________________________1_________________________________________________________________________________________________________________________
16  _____________________________________1__________________________________________________________________________________________________________________________
17  ____________________________________1___________________________________________________________________________________________________________________________
18  ____________________________________1___________________________________________________________________________________________________________________________
19  ___________________________________1____________________________________________________________________________________________________________________________
20  __________________________________1_____________________________________________________________________________________________________________________________
21  __________________________________1_____________________________________________________________________________________________________________________________
22  _________________________________1___________________2__________________________________________________________________________________________________________
23  _________________________________1__________________2___________________________________________________________________________________________________________
24  ________________________________1__________________2____________________________________________________________________________________________________________
25  ________________________________1_________________2_____________________________________________________________________________________________________________
26  _______________________________1______________2222______________________________________________________________________________________________________________
27  _______________________________1______________2_________________________________________________________________________________________________________________
28  _______________________________1______________2_________________________________________________________________________________________________________________
29  ______________________________1______________2__________________________________________________________________________________________________________________
30  ______________________________1______________2__________________________________________________________________________________________________________________
31  _____________________________1_______________2__________________________________________________________________________________________________________________
32  _________________________2___1_______________2__________________________________________________________________________________________________________________
33  _______________________22__11_______________2___________________________________________________________________________________________________________________
34  ______________________2___1_________________2___________________________________________________________________________________________________________________
35  _____________________2_____________________2____________________________________________________________________________________________________________________
36  ____________________2______________________2____________________________________________________________________________________________________________________
37  ____________________2_____________________2_____________________________________________________________________________________________________________________
38  ___________________2______________________2_____________________________________________________________________________________________________________________
39  ___________________2_____________________2______________________________________________________________________________________________________________________
40  __________________2______________________2______________________________________________________________________________________________________________________
41  __________________2______________________2______________________________________________________________________________________________________________________
42  _________________2______________________2_______________________________________________________________________________________________________________________
43  _________________2______________________2_______________________________________________________________________________________________________________________
44  ________________2_____________________22________________________________________________________________________________________________________________________
45  _______________2____________________22__________________________________________________________________________________________________________________________
46  _______________2_____________1____22____________________________________________________________________________________________________________________________
47  ______________2______________1_222______________________________________________________________________________________________________________________________
48  _____________2______________1_1_________________________________________________________________________________________________________________________________
49  ____________2_______________1_1_________________________________________________________________________________________________________________________________
50  ____________2______________1___1________________________________________________________________________________________________________________________________
51  ___________2_____A__.______1___1________________________________________________________________________________________________________________________________ A = 17,51
52  __________2______.________1_____1_______________________________________________________________________________________________________________________________
53  __________2______.________1_____1_______________________________________________________________________________________________________________________________
54  _________2_______._______1______1_______________________________________________________________________________________________________________________________
55  _________2_______._______1______1_______________________________________________________________________________________________________________________________
56  ________2________.______1_______1_______________________________________________________________________________________________________________________________
57  ________2________B______1_______1_______________________________________________________________________________________________________________________________
58  _______2________.______1________1_______________________________________________________________________________________________________________________________
59  _______2_______._______1________1_______________________________________________________________________________________________________________________________
60  ______2_______._______1__________1______________________________________________________________________________________________________________________________
61  ______2______.________12_________1______________________________________________________________________________________________________________________________
62  _____2______.__________2__________1_____________________________________________________________________________________________________________________________
63  _____2_____.__________2___________1____________________________________________________________________________________________________111111___________________
64  ____2_____.___________2___________1___11111111_________________________________________________________________________________________1_____11111122222________
65  ____2____.___________2____________1_11________11111111111_____________________________________________________________________________1________________2________
66  ___2____.____________2____________11_____________________1111________________1111_____________________________________________________1_________________2_______
67  ___2.__.____________2____________2___________________________1______________1___1______________111____________________________________1_________________2_______
68  ____2_1.____________2____________2____________________________111111111111111___111111111111111___111111111111111111111111111111111111__________________2_______
69  ______1.___________2_____________2_________________________._____________________________________________________________________________________________2______
70  _____1_.___________2_____________2__________1111111_______.____________________________________________________________________________________A______1222______
71  _____1_.__________2______________2_________1_______11____._______________11111111_____________111111111________________________________________._______1________
72  ____1__.__________2_______________22_______1______1_____.______2222222222________222222222222__________222222__________________________________._______1________
73  ____1__..________2__________________2222222_____11_____.________2____________________________________________22222222222111____________________.________1_______
74  ____1___.._______2_____________________________1______._________2__________________________________________________________11__________________.________1_______
75  ___1_____..______2_____________________________1_____.___________2___________________________________________________________11________________._________1______
76  ___1______..______2___________________________1_____.___________2______________________________________________________________1_______________._________1______
77  ____1______.._____2___________________________1____.___________2________________________________________________________________11_____________._________1______
78  ____1_____..______22_________________________1____.____________2__________________________________________________________________1____________.________1_______
79  _____1___.._________2________________________1___.____________2____________________________________________________________________1___________.________1_______
80  _____1__..___________22_____________________1___._______222222______________________________________________________________________1__________.________1_______
81  _____1_..______________2____________________1__.________2____________________________________________________________________________1_________.________1_______
82  _____1..________________22_________________1__.________2_____________________________________________________________________________1_________.________1_______
83  ____1..___________________22_______________1_._________2______________________________________________________________________________1________.________1_______
84  ____1.______________________2_____________1_._________22____________________________________________________________________________111________._______1________
85  ____1._______________________22___________1.__________2___________22____________________________________________________________1111___________._______1________
86  ____1.__________________P______2____111111.__________2________2222__22222222222222222222222222222222222222222222222___________11_______________._______1________
87  ____1..........................11111_____.___________2_____222_____________________________________________________2________11..................______11________
88  _____1______________________________________________2_____2________________________________________________________111111111__._____________________11__________
89  _____1_____________________________________________2_____2________________________________________________________________.___.__________________111____________
90  __2221_____________________________________________2____2__________________________________________________________________.__.________________11_______________
91  ___2______________________________________________2_____2___________________________________________________________________._._____________111_________________
92  ____2____________________________________________2_____2_____________________________________________________________________..__________111____________________
93  _____2__________________________________________2_____2..C____________________________________________________________________B_______111_______________________
94  ______2________________________________________2_______2__._________________________________________________________________________11__________________________ C = 57,93 is the strongest position
95  _______22_____________________________________2________2___._________________________________________________________________________222________________________ to zip from
96  _________22________________________________222__________2___.____________________________________________222222222_______________2222___________________________
97  ___________22__________22222222222222222222_____________2____.___________________________2222222222222222_________222222222222222_______________________________
98  _____________2222222222__________________________________2____.__________________________2______________________________________________________________________
99  __________________________________________________________2____._________________________2______________________________________________________________________
100 __________________________________________________________2_____.________________________2______________________________________________________________________
101 ___________________________________________________________2_____._______________________2______________________________________________________________________
102 ___________________________________________________________2______.______________________2______________________________________________________________________
103 ___________________________________________________________2_______.______________________2_____________________________________________________________________
104 ___________________________________________________________2________._____________________2_____________________________________________________________________
105 ___________________________________________________________2_________.____________________2_____________________________________________________________________
106 ___________________________________________________________2__________.___________________2_____________________________________________________________________
107 ___________________________________________________________2___________.__________________2_____________________________________________________________________
108 ___________________________________________________________2____________._________________2_____________________________________________________________________
109 ___________________________________________________________2_____________.________________2_____________________________________________________________________
110 ___________________________________________________________2______________._______________2_____________________________________________________________________
111 ___________________________________________________________2_______________.______________2_____________________________________________________________________
112 ___________________________________________________________2________________._____________2_____________________________________________________________________
113 ___________________________________________________________2_________________.____________2_____________________________________________________________________
114 ___________________________________________________________2__________________.___________2_____________________________________________________________________
115 ___________________________________________________________2___________________.___________2____________________________________________________________________
116 ___________________________________________________________2____________________.__________2____________________________________________________________________
117 ___________________________________________________________2_____________________._________2____________________________________________________________________
118 ___________________________________________________________2______________________.________2____________________________________________________________________
119 ___________________________________________________________2_______________________._______2____________________________________________________________________
120 ___________________________________________________________2________________________.______22222222222__________________________________________________________
121 ___________________________________________________________2_________________________.________________2222______________________________________________________
122 ___________________________________________________________2__________________________.___________________2222__________________________________________________
123 ___________________________________________________________2___________________________.______________________2222______________________________________________
124 ___________________________________________________________2____________________________._________________________222___________________________________________
125 ___________________________________________________________2_____________________________.___________________________2__________________________________________
126 ___________________________________________________________2______________________________.___________________________2_________________________________________
127 ___________________________________________________________2_______________________________.___________________________2________________________________________
128 ___________________________________________________________2________________________________.__________________________2________________________________________
129 _____________________________________________________11111111111111111111111111111111111111xy.__._______________________2_______________________________________
130 ____________________________________________________1______________________________________111z__._______________________2______________________________________
131 __________________________________________________221111111___________________________________11__._______________________2_____________________________________
132 __________________________________________________2________11111111111__________________________11_D______________________2_____________________________________
133 ___________________________________________________2__________________111111_____________________1._____________________22______________________________________
134 ___________________________________________________2________________________11________________111.____________________22________________________________________
135 ____________________________________________________22________________________111_______111111...___________________22__________________________________________
136 ______________________________________________________2__________________________1111111_____.________________222222____________________________________________
137 _______________________________________________________222__________________________________.________________2__________________________________________________
138 __________________________________________________________222______________________________.________________2___________________________________________________
139 _____________________________________________________________2____________________________.________________2____________________________________________________
140 ______________________________________________________________2__________________________.________________2_____________________________________________________
141 ______________________________________________________________2_________________________.________________2______________________________________________________
142 _____________________________________________________________2_________________________.________________2_______________________________________________________
143 _______________________________________222222222222222_____22_________________________.________________2________________________________________________________
144 _________________________________222222_______________22__2__________________________._______________22_________________________________________________________
145 ______________________________222_______________________22__________________________.______2222222222___________________________________________________________
146 ____________________________22____________________F________________________________E______2_____________________________________________________________________ E = 83,146
147 __________________________22_____________________._______________________________________2______________________________________________________________________ F = 50,146
148 _________________________2______________________._____________________________________222_______________________________________________________________________
149 ________________________2______________________.__________________________________2222__________________________________________________________________________
150 _______________________2______________________.__________________________222222222______________________________________________________________________________
151 _______________________2_____________________._________________________22_______________________________________________________________________________________
152 ______________________2_____________________.________________________22_________________________________________________________________________________________
153 _____________________2_____________________._______________________22___________________________________________________________________________________________
154 ____________________2_____________________.______________________22_____________________________________________________________________________________________
155 ____________________2____________________.________2222_________22_______________________________________________________________________________________________
156 ____________________2___________________._________2___222222222_________________________________________________________________________________________________
157 ___________________2___________________._________22_____________________________________________________________________________________________________________
158 ___________________2__________________._______222_______________________________________________________________________________________________________________
159 __________________2__________________.______22__________________________________________________________________________________________________________________
160 _________________2__________________._______2___________________________________________________________________________________________________________________
161 _________________2_________________._______2____________________________________________________________________________________________________________________
162 ________________2_________________.________2____________________________________________________________________________________________________________________
163 _______________2_________________._________2____________________________________________________________________________________________________________________
164 ______________2_________________._________2_____________________________________________________________________________________________________________________
165 ______________2________________.__________2_____________________________________________________________________________________________________________________
166 _____________2________________.__________2______________________________________________________________________________________________________________________
167 ____________2________________.___________2______________________________________________________________________________________________________________________
















