    0         10        20        30        40        50        60        70        80        90        100       110       120       130       140       150       
    0123456789012345678901234567890123456789012345678901234567890123456789012345678901234567890123456789012345678901234567890123456789012345678901234567890123456789
0   ________________________________________________________________________________________________________________________________________________________________
1   ________________________________________________________________________________________________________________________________________________________________
2   ________________________________________________________________________________________________________________________________________________________________
3   ________________________________________________________________________________________________________________________________________________________________
4   ________________________________________________________________________________________________________________________________________________________________
5   ________________________________________________________________________________________________________________________________________________________________
6   ________________________________________________________________________________________________________________________________________________________________
7   ________________________________________________________________________________________________________________________________________________________________
8   ________________________________________________________________________________________________________________________________________________________________
9   ________________________________________________________________________________________________________________________________________________________________
10  ________________________________________________________________________________________________________________________________________________________________
11  ________________________________________________________________________________________________________________________________________________________________
12  ________________________________________________________________________________________________________________________________________________________________
13  ________________________________________________________________________________________________________________________________________________________________
14  ________________________________________________________________________________________________________________________________________________________________
15  ________________________________________________________________________________________________________________________________________________________________
16  ________________________________________________________________________________________________________________________________________________________________
17  ________________________________________________________________________________________________________________________________________________________________
18  ________________________________________________________________________________________________________________________________________________________________
19  ________________________________________________________________________________________________________________________________________________________________
20  ________________________________________________________________________________________________________________________________________________________________
21  ________________________________________________________________________________________________________________________________________________________________
22  ________________________________________________________________________________________________________________________________________________________________
23  ________________________________________________________________________________________________________________________________________________________________
24  ________________________________________________________________________________________________________________________________________________________________
25  ________________________________________________________________________________________________________________________________________________________________
26  ________________________________________________________________________________________________________________________________________________________________
27  ________________________________________________________________________________________________________________________________________________________________
28  ________________________________________________________________________________________________________________________________________________________________
29  ________________________________________________________________________________________________________________________________________________________________
30  ________________________________________________________________________________________________________________________________________________________________
31  ________________________________________________________________________________________________________________________________________________________________
32  ________________________________________________________________________________________________________________________________________________________________
33  ________________________________________________________________________________________________________________________________________________________________
34  ________________________________________________________________________________________________________________________________________________________________
35  ________________________________________________________________________________________________________________________________________________________________
36  ________________________________________________________________________________________________________________________________________________________________
37  ________________________________________________________________________________________________________________________________________________________________
38  ________________________________________________________________________________________________________________________________________________________________
39  22______________________________________________________________________________________________________________________________________________________________
40  __222___________________________________________________________________________________________________________________________________________________________
41  _____222________________________________________________________________________________________________________________________________________________________
42  ________22______________________________________________________________________________________________________________________________________________________
43  __________222___________________________________________________________________________________________________________________________________________________
44  _____________222________________________________________________________________________________________________________________________________________________
45  ________________222_____________________________________________________________________________________________________________________________________________
46  ___________________2222_________________________________________________________________________________________________________________________________________
47  _______________________22222____________________________________________________________________________________________________________________________________
48  ____________________________22222_______________________________________________________________________________________________________________________________
49  _________________________________22222__________________________________________________________________________________________________________________________
50  ______________________________________222_______________________________________________________________________________________________________________________
51  _________________________________________22_____________________________________________________________________________________________________________________
52  ___________________________________________22___________________________________________________________________________________________________________________
53  _____________________________________________22_________________________________________________________________________________________________________________
54  22_____________________________________________2________________________________________________________________________________________________________________
55  __222___________________________________________22______________________________________________________________________________________________________________
56  _____222__________________________________________2_____________________________________________________________________________________________________________
57  ________22_________________________________________2____________________________________________________________________________________________________________
58  __________222_______________________________________22__________________________________________________________________________________________________________
59  _____________222______________________________________2_________________________________________________________________________________________________________
60  ________________222222222222___________________________22_______________________________________________________________________________________________________
61  ____________________________22___________________________22_____________________________________________________________________________________________________
62  ______________________________22___________________________2222___22222222222222222222222222222222222222222222___________________1______________________________
63  ________________________________22_____________________________222____________________________________________2222_______________1______________________________
64  __________________________________2_______________________________________________________________________________2222__________11___________________________1__
65  ___________________________________22_________________________________________________________________________________2222______11___________________________1__
66  _____________________________________22___________________________________________________________________________________2222__11___________________________1__
67  _______________________________________2______________________________________________________________________________________2211___________________________1__
68  ________________________________________2_______________________________________________________________________________________112222222____________________1__
69  _________________________________________2______________________________________________________________________________________11_______2222222222222_______1__
70  __________________________________________22____________________________________________________________________________________11____________________22222221__
71  ____________________________________________2________________________________________________________________________________________________________________1__
72  _____________________________________________2_____________________________________________________________________________________________________11111111111__
73  ______________________________________________2____________________________________________________________________________________________________1____________
74  _______________________________________________22___________________________________________________________________________________________________1___________
75  _________________________________________________22__________________________________________________________________________________________________1__________
76  ___________________________________________________22_________________________________________________________________________________________________1_________
77  _____________________________________________________22________________________________________________________________________________________________111111___
78  _______________________________________________________22__________222222___________________________________________________________________________________1___
79  _________________________________________________________2222222222______222222_____________________________________________________________________________1___
80  _______________________________________________________________________________22___________________________________________________________________________1___
81  _________________________________________________________________________________22222222222_________________________________________________________________1__
82  ____________________________________________________________________________________________2222_____________________________________________________________1__
83  ________________________________________________________________________________________________2222____________________________________________________111111__
84  ____________________________________________________________________________________________________222____________________________________________11111________
85  _____________________________________________________________________________________________________2_____________________________________________1____________
86  _____________________________________________________________________________________________________2_____________________________________________1____________
87  ____________________________________________________________________________________________________2______________________________________________1____________
88  ___________________________________________________________________________________________________2_______________________________________________1____________
89  ___________________________________________________________________________________________________2_______________________________________________1____________
90  ______________________________________________________________________________________________22222________________________________________________111111_______
91  ____________________________________________________________________________________________22___________________________________________________________11111__
92  __________________________________________________________________________________________22_________________________________________________________________1__
93  _________________________________________________________________________________________2___________________________________________________________________1__
94  _______________________________________________________________________________________22__________________________________________________________11111111111__
95  _____________________________________________________________________________________22_________________________________________________________111_____________
96  ____________________________________________________________________________________2_________________________________________________________11________________
97  __________________________________________________________________________________22__________________________________________________________1_________________
98  _________________________________________________________________________________2_____________________________________________________________1________________
99  ________________________________________________________________________________2_______________________________________________________________1_______________
100 ______________________________________________________________________________22_________________________________________________________________11_____________
101 _____________________________________________________________________________2_____________________________________________________________________11___________
102 ____________________________________________________________________________2_______________________________________________________________________1___________
103 ___________________________________________________________________________2_________________________________________________________________________1__________
104 _________________________________________________________________________22__________________________________________________________________________1__________
105 ________________________________________________________________________2____________________________________________________________________________1__________
106 _______________________________________________________________________2______________________________________________________________________________1_________
107 _____________________________________________________________________22_______________________________________________________________________________111_______
108 ____________________________________________________________________2____________________________________________________________________________________1111___
109 ___________________________________________________________________2_________________________________________________________________________________________11_
110 __________________________________________________________________2___________________________________________________________________________________________1_
111 _________________________________________________________________2____________________________________________________________________________________________1_
112 _______________________________________________________________22_____________________________________________________________________________________________1_
113 ______________________________________________________________2________________________________________________________________________________________________1
114 _____________________________________________________________2_________________________________________________________________________________________________1
115 ____________________________________________________________2__________________________________________________________________________________________________1
116 ___________________________________________________________2_________________________________________________________________________111111111111111111111111111
117 _________________________________________________________22_________________________________________________________________________1___________________________
118 ________________________________________________________2__________________________________________________________________________1____________________________
119 _______________________________________________________2__________________________________________________________________________1_____________________________
120 ______________________________________________________2__11111111111111111111____________________________________________________11_____________________________
121 _____________________________________________________2___1________1________________________________________________________________111111111111_________________
122 ____________________________________________________2____1_______1_____________________________________________________________________________111______________
123 __________________________________________________22_____1_______1________________________________________________________________________________1_____________
124 _________________________________________________2______1_______1__________________________________________________________________________________1______111111
125 ________________________________________________2_______1_____11____________________________________________________________________________________111111_____1
126 _______________________________________________2________1____1_________________________________________________________________________________________________1
127 ______________________________________________2_________1__11__________________________________________________________________________________________________1
128 _____________________________________________2___________11____________________________________________________________________________________________________1
129 ____________________________________________2__________________________________________________________________________________________________________________1
130 ___________________________________________2___________________________________________________________________________________________________________________1
131 __________________________________________2____________________________________________________________________________________________________________________1
132 _________________________________________2_____________________________________________________________________________________________________________________1
133 ________________________________________2______________________________________________________________________________________________________________________1
134 _______________________________________2______________________________________________________________________________________________________________________1_
135 ______________________________________2_______________________________________________________________________________________________________________________1_
136 ______________________________________2______________________________________________________________________________________________________________________1__
137 _____________________________________2_______________________________________________________________________________________________________________________1__
138 ____________________________________2_______________________________________________________________________________________________________________________1___
139 ___________________________________2________________________________________________________________________________________________________________________1___
140 ___________________________________2_______________________________________________________________________________________________________________________1____
141 __________________________________2________________________________________________________________________________________________________________________1____
142 ________________________________22________________________________________________________________________________________________________________________1_____
143 ______________________________22__________________________________________________________________________________________________________________________1_____
144 ____________________________22___________________________________________________________________________________________________________________________1______
145 __________________________22_____________________________________________________________________________________________________________________________1______
146 ________________________22______________________________________________________________________________________________________________________________1_______
147 ______________________22________________________________________________________________________________________________________________________________1_______
148 ____________________22_________________________________________________________________________________________________________________________________1________
149 ___________________2________________________________________________________________________________111________________________________________________1________
150 __________________2__1111111______________________________________________________________________11___1111___________________________________________1_________
151 ________________22__1_______11__________________________________________________________________11_________111_______________________________________1__________
152 _______________2____1_________11_______________________________________________________________1______________1_____________________________________1___________
153 ______________2____1____________1_____________________________________________________________1________________1____________________________________1___________
154 _____________2_____1____________1____________________________________________________________1__________________1__________________________________1____________
155 ____________2_____1____________11___________________________________________________________1________________11111________________________________1_____________
156 __________22______1__________11______________________________________________________________11______11111111____________________________________1______________
157 _________2_______1_________11__________________________________________________________________111111___________________________________________1_______________
158 ________2________1_______11____________________________________________________________________________________________________________________1________________
159 _______2_________1_____11______________________________________________________________________________________________________________________1________________
160 ______2_________1____11_______________________________________________________________________________________________________________________1_________________
161 _____2__________11111________________________________________________________________________________________________________________________1__________________
162 ___22_______________________________________________________________________________________________________________________________________1___________________
163 __2_______________________________________________________________________________________________________________________________________11____________________
164 _2______________________________________________________________________________________________________________________________________11______________________
165 2_____________________________________________________________________________________________________________________________________11________________________
166 ____________________________________________________________________________________________________________________________________11__________________________
167 ___________________________________________________________________________________________________________________________________1____________________________
