    0         10        20        30        40        50        60        70        80        90        100       110       120       130       140       150       
    0123456789012345678901234567890123456789012345678901234567890123456789012345678901234567890123456789012345678901234567890123456789012345678901234567890123456789
0   ________________________________________________________________________________________________________________________________________________________________
1   ________________________________________________________________________________________________________________________________________________________________
2   ________________________________________________________________________________________________________________________________________________________________
3   ________________________________________________________________________________________________________________________________________________________________
4   ________________________________________________________________________________________________________________________________________________________________
5   ________________________________________________________________________________________________________________________________________________________________
6   ________________________________________________________________________________________________________________________________________________________________
7   ________________________________________________________________________________________________________________________________________________________________
8   ________________________________________________________________________________________________________________________________________________________________
9   ________________________________________________________________________________________________________________________________________________________________
10  ________________________________________________________________________________________________________________________________________________________________
11  ________________________________________________________________________________________________________________________________________________________________
12  ________________________________________________________________________________________________________________________________________________________________
13  ________________________________________________________________________________________________________________________________________________________________
14  ________________________________________________________________________________________________________________________________________________________________
15  ________________________________________________________________________________________________________________________________________________________________
16  ________________________________________________________________________________________________________________________________________________________________
17  ________________________________________________________________________________________________________________________________________________________________
18  ________________________________________________________________________________________________________________________________________________________________
19  ________________________________________________________________________________________________________________________________________________________________
20  ________________________________________________________________________________________________________________________________________________________________
21  ________________________________________________________________________________________________________________________________________________________________
22  ________________________________________________________________________________________________________________________________________________________________
23  ________________________________________________________________________________________________________________________________________________________________
24  ________________________________________________________________________________________________________________________________________________________________
25  ________________________________________________________________________________________________________________________________________________________________
26  ________________________________________________________________________________________________________________________________________________________________
27  ________________________________________________________________________________________________________________________________________________________________
28  ________________________________________________________________________________________________________________________________________________________________
29  ________________________________________________________________________________________________________________________________________________________________
30  ________________________________________________________________________________________________________________________________________________________________
31  ________________________________________________________________________________________________________________________________________________________________
32  ________________________________________________________________________________________________________________________________________________________________
33  ________________________________________________________________________________________________________________________________________________________________
34  ________________________________________________________________________________________________________________________________________________________________
35  ________________________________________________________________________________________________________________________________________________________________
36  ________________________________________________________________________________________________________________________________________________________________
37  ________________________________________________________________________________________________________________________________________________________________
38  ________________________________________________________________________________________________________________________________________________________________
39  ________________________________________________________________________________________________________________________________________________________________
40  ________________________________________________________________________________________________________________________________________________________________
41  ________________________________________________________________________________________________________________________________________________________________
42  ________________________________________________________________________________________________________________________________________________________________
43  ________________________________________________________________________________________________________________________________________________________________
44  ________________________________________________________________________________________________________________________________________________________________
45  ________________________________________________________________________________________________________________________________________________________________
46  ________________________________________________________________________________________________________________________________________________________________
47  ________________________________________________________________________________________________________________________________________________________________
48  ________________________________________________________________________________________________________________________________________________________________
49  ________________________________________________________________________________________________________________________________________________________________
50  ________________________________________________________________________________________________________________________________________________________________
51  ________________________________________________________________________________________________________________________________________________________________
52  ________________________________________________________________________________________________________________________________________________________________
53  ________________________________________________________________________________________________________________________________________________________________
54  ________________________________________________________________________________________________________________________________________________________________
55  ________________________________________________________________________________________________________________________________________________________________
56  ________________________________________________________________________________________________________________________________________________________________
57  ________________________________________________________________________________________________________________________________________________________________
58  ________________________________________________________________________________________________________________________________________________________________
59  ________________________________________________________________________________________________________________________________________________________________
60  ________________________________________________________________________________________________________________________________________________________________
61  ________________________________________________________________________________________________________________________________________________________________
62  ________________________________________________________________________________________________________________________________________________________________
63  ________________________________________________11111___________________________________________________________________________________________________________
64  ________________________________________________1___1___________________________________________________________________________________________________________
65  ________________________________________11111___1___1___11111___________________________________________________________________________________________________
66  ________________________________________1___1___1___1___1___1___________________________________________________________________________________________________
67  ________________________________________1___1___1___1___1___1___________________________________________________________________________________________________
68  ________________________________________1___1___1___1___1___1___________________________________________________________________________________________________
69  ________________________________11111___1___1___1___1___1___1___11111___________________________________________________________________________________________
70  ________________________________1___1___1___1___1___1___1___1___1___1___________________________________________________________________________________________
71  ________________________________1___1___1___1___1___1___1___1___1___1___________________________________________________________________________________________
72  ________________________________1___1___1___1___1___1___1___1___1___1___________________________________________________________________________________________
73  ________________________________1___1___1___1___1___1___1___1___1___1___________________________________________________________________________________________
74  ________________________________1___1___1___1___1___1___1___1___1___1___________________________________________________________________________________________
75  ________________________________1___1___1___1___1___1___1___1___1___1___________________________________________________________________________________________
76  ________________________________1___1___1___1___1___1___1___1___1___1___________________________________________________________________________________________
77  ________________________________1___1___1___1___1___1___1___1___1___1___________________________________________________________________________________________
78  ________________________________1___1___1___1___1___1___1___1___1___1___________________________________________________________________________________________
79  ________________________________1___1___1___1___1___1___1___1___1___1___________________________________________________________________________________________
80  ________________________________1___1___1___1___1___1___1___1___1___1___________________________________________________________________________________________
81  ________________________________1___1___1___1___1___1___1___1___1___1___________________________________________________________________________________________
82  ________________________________1___1___1___1___1__111111___1___1___1___________________________________________________________________________________________
83  ________________________________1___1___1___1___111______1__1___1___1___________________________________________________________________________________________
84  ________________________________1___1___1___11111_________111___1___1___________________________________________________________________________________________
85  __________1111111111111_________1___1___1____11_____________11111___111111111111________________________________________________________________________________
86  _111111111_____________1111111111111111111111________________11111111___________1111____________________________________________________________________________
87  _____________________________________1111___________________________________________1___________________________________________________________________________
88  _____________________________________________________________________________________1__________________________________________________________________________
89  ______________________________________________________________________________________1_________________________________________________________________________
90  _______________________________________________________________________________________1________________________________________________________________________
91  ________________________________________________________________________________________1_______________________________________________________________________
92  _________________________________________________________________________________________1______________________________________________________________________
93  __________________________________________________________________________________________1_____________________________________________________________________
94  ___________________________________________________________________________________________1____________________________________________________________________
95  ____________________________________________________________________________________________1___________________________________________________________________
96  _________________________________________________________________________________33__________1__________________________________________________________________
97  __________________________________________________________________________________3___________1_________________________________________________________________
98  ________________________________________________________________________________1_3____________1________________________________________________________________
99  _______________________________________________________________________________12_3_____________1_______________________________________________________________
100 ______________________________________________________________________________1_123______________1______________________________________________________________
101 _____________________________________________________________________________1___123333___________1_____________________________________________________________
102 _____________________________________________________________________________1____12333____________1____________________________________________________________
103 _________111111111111111111111111111________________________________________1_____31233_____________1___________________________________________________________
104 _11111111_____1____________________1_______________________________________1______33123______________1__________________________________________________________
105 _______________1__________________1_______________________________________1________33123333___________1_________________________________________________________
106 ________________1_________________1_____________________________________11_________33312333____________1________________________________________________________
107 _________________111111111111111111__________________________________111___________33331233_____________1_______________________________________________________
108 ___________________1______________________________________________111______________33333123______________11_____________________________________________________
109 ____________________1111111_____________111111_________________111_________________333333123333____________1____________________________________________________
110 _______________________111111_____111111______1111___________11____________________333333312333_____________1___________________________________________________
111 _____________________________11111________________1_______111______________________333333331233______________1__________________________________________________
112 ___________________________________________________11__111__________________________33333333123_______________1_________________________________________________
113 _____________________________________________________11_____________________________333333333123333____________1________________________________________________
114 _____________________________________________________________________________________33333333312333_____________1_______________________________________________
115 _______________________________________________________________________________________333333331233______________1______________________________________________
116 _________________________________________________________________________________________3333333123_______________1_____________________________________________
117 __________________________________________________________________________________________3333333123333____________1____________________________________________
118 ___________________________________________________________________________________________333333312333_____________1___________________________________________
119 ____________________________________________________________________________________________33333331233______________1__________________________________________
120 _____________________________________________________________________________________________3333333123_______________1_________________________________________
121 _____________________________________________________________________________________________33333333123333____________1________________________________________
122 ______________________________________________________________________________________________3333333312333_____________1_______________________________________
123 _______________________________________________________________________________________________333333331233______________1______________________________________
124 ________________________________________________________________________________________________33333333123_______________1_____________________________________
125 ________________________________________________________________________________________________333333333123333____________1____________________________________
126 _________________________________________________________________________________________________33333333312333_____________1___________________________________
127 __________________________________________________________________________________________________3333333331233______________1__________________________________
128 ___________________________________________________________________________________________________333333333123_______________1_________________________________
129 ____________________________________________________________________________________________________333333333123333____________1________________________________
130 ____________________________________________________________________________________________________333333333312333_____________1_______________________________
131 _____________________________________________________________________________________________________33333333331233______________1______________________________
132 ______________________________________________________________________________________________________3333333333123_______________1_____________________________
133 ______________________________________________________________________________________________________33333333333123333____________1____________________________
134 ______________________________________________________________________________________________________33333333333312333_____________1___________________________
135 _______________________________________________________________________________________________________3333333333331233______________1__________________________
136 _______________________________________________________________________________________________________3333333333333123_______________1_________________________
137 _______________________________________________________________________________________________________33333333333333123333____________1________________________
138 _______________________________________________________________________________________________________33333333333333312333_____________1_______________________
139 ________________________________________________________________________________________________________3333333333333331233______________1______________________
140 ________________________________________________________________________________________________________3333333333333333123_______________1_____________________
141 _________________________________________________________________________________________________________33333333333333331233_1____________1____________________
142 _________________________________________________________________________________________________________33333333333333333123__1____________11__________________
143 ___________________________________________________________________________________________________________333333333333333312__1______________1_________________
144 ____________________________________________________________________________________________________________333333333333333312__1______________1________________
145 ______________________________________________________________________________________________________________33333333333333_12_1_______________1_______________
146 _______________________________________________________________________________________________________________333333333333___12_1_______________1______________
147 ________________________________________________________________________________________________________________33333333333____121________________1_____________
148 _________________________________________________________________________________________________________________333333333______121333_____________1____________
149 __________________________________________________________________________________________________________________33333333_______12333______________1___________
150 ___________________________________________________________________________________________________________________333333_________1233_______________1__________
151 ____________________________________________________________________________________________________________________33333__________123________________1_________
152 _____________________________________________________________________________________________________________________333____________123333_____________1________
153 ______________________________________________________________________________________________________________________3_____________312333______________1_______
154 ____________________________________________________________________________________________________________________________________331233_______________1______
155 ____________________________________________________________________________________________________________________________________333123________________1_____
156 ____________________________________________________________________________________________________________________________________3333123333_____________1____
157 _____________________________________________________________________________________________________________________________________333312333______________1___
158 _____________________________________________________________________________________________________________________________________333331233_______________1__
159 _____________________________________________________________________________________________________________________________________333333123________________1_
160 _____________________________________________________________________________________________________________________________________3333333123333______________
161 ______________________________________________________________________________________________________________________________________333333312333______________
162 ______________________________________________________________________________________________________________________________________333333331233______________
163 _______________________________________________________________________________________________________________________________________33333333123______________
164 ________________________________________________________________________________________________________________________________________33333333123333__________
165 ________________________________________________________________________________________________________________________________________33333333312333__________
166 _________________________________________________________________________________________________________________________________________3333333331233__________
167 ___________________________________________________________________________________________________________________________________________________12___________
