    0         10        20        30        40        50        60        70        80        90        100       110       120       130       140       150       
    0123456789012345678901234567890123456789012345678901234567890123456789012345678901234567890123456789012345678901234567890123456789012345678901234567890123456789
0   ________________________________________________________________________________________________________________________________________________________________
1   ________________________________________________________________________________________________________________________________________________________________
2   ________________________________________________________________________________________________________________________________________________________________
3   ________________________________________________________________________________________________________________________________________________________________
4   ________________________________________________________________________________________________________________________________________________________________
5   ________________________________________________________________________________________________________________________________________________________________
6   ________________________________________________________________________________________________________________________________________________________________
7   ________________________________________________________________________________________________________________________________________________________________
8   ________________________________________________________________________________________________________________________________________________________________
9   ________________________________________________________________________________________________________________________________________________________________
10  ________________________________________________________________________________________________________________________________________________________________
11  ________________________________________________________________________________________________________________________________________________________________
12  ________________________________________________________________________________________________________________________________________________________________
13  ________________________________________________________________________________________________________________________________________________________________
14  ________________________________________________________________________________________________________________________________________________________________
15  ________________________________________________________________________________________________________________________________________________________________
16  ________________________________________________________________________________________________________________________________________________________________
17  ________________________________________________________________________________________________________________________________________________________________
18  ________________________________________________________________________________________________________________________________________________________________
19  ________________________________________________________________________________________________________________________________________________________________
20  ________________________________________________________________________________________________________________________________________________________________
21  ________________________________________________________________________________________________________________________________________________________________
22  ________________________________________________________________________________________________________________________________________________________________
23  ________________________________________________________________________________________________________________________________________________________________
24  ________________________________________________________________________________________________________________________________________________________________
25  ________________________________________________________________________________________________________________________________________________________________
26  ________________________________________________________________________________________________________________________________________________________________
27  ________________________________________________________________________________________________________________________________________________________________
28  ________________________________________________________________________________________________________________________________________________________________
29  ________________________________________________________________________________________________________________________________________________________________
30  ________________________________________________________________________________________________________________________________________________________________
31  ________________________________________________________________________________________________________________________________________________________________
32  __________________________________________________________________________________________________________________1_____________________________________________
33  __________________________________________________________________________________________________________________1_____________________________________________
34  __________________________________________________________________________________________________________________1_____________________________________________
35  __________________________________________________________________________________________________________________1_____________________________________________
36  __________________________________________________________________________________________________________________1_____________________________________________
37  __________________________________________________________________________________________________________________1_____________________________________________
38  ___________________________________________________________________________________________________________________1____________________________________________
39  ___________________________________________________________________________________________________________________1____________________________________________
40  ___________________________________________________________________________________________________________________1____________________________________________
41  ___________________________________________________________________________________________________________________1____________________________________________
42  ___________________________________________________________________________________________________________________1____________________________________________
43  ___________________________________________________________________________________________________________________1____________________________________________
44  ___________________________________________________________________________________________________________________1____________________________________________
45  ____________________________________________________________________________________________________________________1___________________________________________
46  ____________________________________________________________________________________________________________________1___________________________________________
47  ____________________________________________________________________________________________________________________1___________________________________________
48  ___________________________________________________________________________________________________________________1____________________________________________
49  ___________________________________________________________________________________________________________________1____________________________________________
50  __________________________________________________________________________________________________________________1_____________________________________________
51  __________________________________________________________________________________________________________________1_____________________________________________
52  _________________________________________________________________________________________________________________1______________________________________________
53  _________________________________________________________________________________________________________________1_1____________________________________________
54  ________________________________________________________________________________________________________________1__11___________________________________________
55  _______________________________________________________________________________________________________________1____11__________________________________________
56  __________________1111111______________________________________________________________________________________1____1_1_________________________________________
57  ________________11_______11___________________________________________________________________________________1______1_1________________________________________
58  ______________11___________1111111111111_____________________________________________________________________1_______1__1_______________________________________
59  _____________1_______1111111111111111111______________________________________________________________1111111_________1__11_____________________________________
60  ______________1111111__________________________________________________________________________11111111______11_______111111____________________________________
61  ______________________________________________________________________________________________1_____1__11__11_11111111_1___11___________________________________
62  _______________________________________________________________________________________________1___1__11111111___1_____1___1_1__________________________________
63  ________________________________________________________________________________________________11111111111111111_11____1___1_1_________________________________
64  _________________________________________________________________________________________________________________1__1___1___1__1________________________________
65  __________________________________________________________________________________________________________________1__11__1___1__1_______________________________
66  ___________________________________________________________________________________________________________________1___1_1____1__1______________________________
67  ____________________________________________________________________________________________________________________1___111___1__1______________________________
68  _____________________________________________________________________________________________________________________1____1____1__1_____________________________
69  ______________________________________________________________________________________________________________________11_______1__1_____________________________
70  ___________________________11111111111111111____________________________________________________________________________1111111_1__1____________________________
71  _________________________11_________________11_________________________________________________________________________________11__1____________________________
72  _______________________11___________________111________________________________________________________________________________1_111____________________________
73  _______________________111111_________111111____________________________________________________________________________________1__111__________________________
74  _____________________________111111111__________________________________________________________________________________________1___1_111_______________________
75  _________________________________________________________________________________________________________________________________1___1___111____________________
76  __________________________________________________________________________________________________________________________________1__11_____11__________________
77  __________________________________________________________________________________________________________________________________1____11_____1_________________
78  ___________________________________________________________________________________________________________________________________1_____1____1_________________
79  ____________________________________________________________________________________________________________________________________11____11___1________________
80  ______________________________________________________________________________________________________________________________________1_____1__1________________
81  _______________________________________________________________________________________________________________________________________1_____1__1_______________
82  ________________________________________________________________________________________________________________________________________11____1_1_______________
83  __________________________________________________________________________________________________________________________________________1____1_1______________
84  ___________________________________________________________________________________________________________________________________________11___111_____________
85  _____________________________________________________________________________________________________________________________________________1____1_____________
86  ______________________________________________________________________________________________________________________________________________11___1____________
87  ________________________________________________________________________________________________________________________________________________11_11___________
88  __________________________________________________________________________________________________________________________________________________1_11__________
89  ___________________________________________________________________________________________________________________________________________________11111________
90  _____________________________________________________________________________________________________________________________________________________1__1_______
91  ______________________________________________________________________________________________________________________________________________________1111______
92  _______________________________________________________________________________________________________________________________________111111111111111111_1_____
93  _____________________________________________________________________________________________________________________________________11______11111_____1___1____
94  _________________________________________111111111111111111111_____________________________________________________________________11___111111_1______11____11__
95  _____________________________________1111__1111111_________1__111________________________________________________________________11__111____1___1____1__1_____1_
96  _____________________________________111___1_____1_________1_____11_______________________________________________________________1____11__1_____1__1____1_____1
97  ________________________________________1111_____11111111111__111__________________________________________________________________1_____11_______11_____1______
98  ____________________________________________111111111111111111______________________________________________________________________1____1_11_____11______1_____
99  _____________________________________________________________________________________________________________________________________1__11___11__1__1_____1_____
100 ______________________________________________________________________________________________________________________________________11__111__11____1_____1____
101 ________________________________________________________________________________________________________________________________________1____111_11___1_____1___
102 _________________________________________________________________________________________________________________________________________1____1_11_11__1____1___
103 __________________________________________________________________________________________________________________________________________11_1____11111_1____1__
104 ____________________________________________________________________________________________________________________________________________11_______11111___1__
105 ______________________________________________________________________________________________________________________________________________11________111___1_
106 ________________________________________________________________________________________________________________________________________________11111111___1__1_
107 ________________________________________________________________________________________________________________________________________________________1___1__1
108 _________________________________________________________________________________________________________________________________________________________1___1__
109 __________________________________________________________________________________________________________________________________________________________1___1_
110 ___________________________________________________________________________________________________________________________________________________________1___1
111 ____________________________________________________________________________________________________________________________________________________________1___
112 _____________________________________________________________________________________________________________________________________________________________1__
113 ______________________________________________________________________________________________________________________________________________________________1_
114 _______________________________________________________________________________________________________________________________________________________________1
115 ________________________________________________________________________________________________________________________________________________________________
116 ________________________________________________________________________________________________________________________________________________________________
117 _______________________________________________________________________________________________1111_____________________________________________________________
118 _______1111111_______________________________________________________________________________11____111__________________________________________________________
119 _______1______1_____________________________________________________________________________1111_11111__________________________________________________________
120 ______1111111111_______________________________________________________________________________1_1______________________________________________________________
121 ________________________________________________________________________________________________1_______________________________________________________________
122 ________________________________________________________________________________________________1_______________________________________________________________
123 ________________________________________________________________________________________________________________________________________________________________
124 ________________________________________________________________________________________________________________________________________________________________
125 ________________________________________________________________________________________________________________________________________________________________
126 ________________________________________________________________________________________________________________________________________________________________
127 ________________________________________________________________________________________________________________________________________________________________
128 ________________________________________________________________________________________________________________________________________________________________
129 ________________________________________________________________________________________________________________________________________________________________
130 ________________________________________________________________________________________________________________________________________________________________
131 ________________________________________________________________________________________________________________________________________________________________
132 ________________________________________________________________________________________________________________________________________________________________
133 ________________________________________________________________________________________________________________________________________________________________
134 ________________________________________________________________________________________________________________________________________________________________
135 ________________________________________________________________________________________________________________________________________________________________
136 ________________________________________________________________________________________________________________________________________________________________
137 ________________________________________________________________________________________________________________________________________________________________
138 ________________________________________________________________________________________________________________________________________________________________
139 _____________________________________________________________________________________________________11111111111111111111111111111111___________________________
140 _________________________________________________________________________________________________1111_1_______111111111________1_____1111_______________________
141 _______________________________________________________________________________________________11_____1_______1_______1________1_________11_____________________
142 _______________________________________________________________________________________________1______1_______1_______1111111111__________1_____________________
143 _______________________________________________________________________________________________1111___11111111111111111111111______11111111_____________________
144 ___________________________________________________________________________________________________11111111__________________111111_____________________________
145 ________________________________________________________________________________________________________________________________________________________________
146 ________________________________________________________________________________________________________________________________________________________________
147 ________________________________________________________________________________________________________________________________________________________________
148 ________________________________________________________________________________________________________________________________________________________________
149 ________________________________________________________________________________________________________________________________________________________________
150 ________________________________________________________________________________________________________________________________________________________________
151 ________________________________________________________________________________________________________________________________________________________________
152 ________________________________________________________________________________________________________________________________________________________________
153 ________________________________________________________________________________________________________________________________________________________________
154 ________________________________________________________________________________________________________________________________________________________________
155 ________________________________________________________________________________________________________________________________________________________________
156 ________________________________________________________________________________________________________________________________________________________________
157 ________________________________________________________________________________________________________________________________________________________________
158 ________________________________________________________________________________________________________________________________________________________________
159 ________________________________________________________________________________________________________________________________________________________________
160 ________________________________________________________________________________________________________________________________________________________________
161 ________________________________________________________________________________________________________________________________________________________________
162 ________________________________________________________________________________________________________________________________________________________________
163 ________________________________________________________________________________________________________________________________________________________________
164 ________________________________________________________________________________________________________________________________________________________________
165 ________________________________________________________________________________________________________________________________________________________________
166 ________________________________________________________________________________________________________________________________________________________________
167 ________________________________________________________________________________________________________________________________________________________________
