    0         10        20        30        40        50        60        70        80        90        100       110       120       130       140       150       
    0123456789012345678901234567890123456789012345678901234567890123456789012345678901234567890123456789012345678901234567890123456789012345678901234567890123456789
0   ________________________________________________________________________________________________________________________________________________________________
1   ________________________________________________________________________________________________________________________________________________________________
2   ________________________________________________________________________________________________________________________________________________________________
3   ________________________________________________________________________________________________________________________________________________________________
4   ________________________________________________________________________________________________________________________________________________________________
5   ________________________________________________________________________________________________________________________________________________________________
6   ________________________________________________________________________________________________________________________________________________________________
7   ________________________________________________________________________________________________________________________________________________________________
8   ________________________________________________________________________________________________________________________________________________________________
9   ________________________________________________________________________________________________________________________________________________________________
10  ________________________________________________________________________________________________________________________________________________________________
11  ________________________________________________________________________________________________________________________________________________________________
12  ________________________________________________________________________________________________________________________________________________________________
13  ________________________________________________________________________________________________________________________________________________________________
14  ________________________________________________________________________________________________________________________________________________________________
15  ________________________________________________________________________________________________________________________________________________________________
16  ________________________________________________________________________________________________________________________________________________________________
17  ________________________________________________________________________________________________________________________________________________________________
18  ________________________________________________________________________________________________________________________________________________________________
19  ________________________________________________________________________________________________________________________________________________________________
20  ________________________________________________________________________________________________________________________________________________________________
21  ______________________________________________________________222_______________________________________________________________________________________________
22  ______________________________________________________________1__22222__________________________________________________________________________________________
23  ______________________________________________________________1_______2222______________________________________________________________________________________
24  ______________________________________________________________1___________222___________________________________________________________________________________
25  _______________________________________________________________1_____________22_________________________________________________________________________________
26  _______________________________________________________________1_______________222______________________________________________________________________________
27  _______________________________________________________________1__________________222___________________________________________________________________________
28  _______________________________________________________________1_____________________22_________________________________________________________________________
29  _______________________________________________________________1_______________________22_______________________________________________________________________
30  _______________________________________________________________1_________________________2______________________________________________________________________
31  ________________________________________________________________1_________________________2_____________________________________________________________________
32  ________________________________________________________________1__________________________2____________________________________________________________________
33  ________________________________________________________________1___________________________2___________________________________________________________________
34  ________________________________________________________________1___________________________2___________________________________________________________________
35  ________________________________________________________________1___________________________2___________________________________________________________________
36  _______________________________________________________________1____________________________2___________________________________________________________________
37  ___________________________________________________________11111____________________________2___________________________________________________________________
38  ___________________________________________________11111111_________________________________2___________________________________________________________________
39  ___________________________________________11111111_________________________________________2___________________________________________________________________
40  _______________________________________1111_______________________________________________22____________________________________________________________________
41  11____________________________________1__________________________________________________2______________________________________________________________________
42  __1111_________________________11111111_________________________________________________2_______________________________________________________________________
43  ______11______________________1_______________________________________________________22________________________________________________________________________
44  ________1_____________________1______________________________________________________2________________________________111_______________________________________
45  _________1___________________1________________________________________________2222222_____________________________2111___11_____________________________________
46  __________1________________111__________________________________________222222_____________1222222________________2________1____________________________________
47  ___________1_____1111111111____________________________________________2___________________1______22____________222_________1___________________________________
48  ____________1__11_____________________________________________________2____________________1________22____222222_____________11_________________________________
49  _____________11______________________________________________________2_____________________1__________2222_____________________1________________________________
50  ________________________________________________222222222222222222222______________________1____________________________________1_______________________________
51  ____________________________________________2222___________________________________________1____________________________________1_______________________________
52  ___________________________________________2_______________________________________________1____________________________________1_______________________________
53  ___________________________________________2_______________________________________________1_____________________________________1______________________________
54  __________________________________________2________________________________________________1______________________________________1_____________________________
55  2________________________________________2_________________________________________________1_______________________________________1____________________________
56  _22_____________________________________2__________________________________________________1________________________________________1___________________________
57  ___222222222____________________________2__________________________________________________1_________________________________________1__________________________
58  ____________22____________22222222222222___________________________________________________1__________________________________________1_________________________
59  ______________222222222222_________________________________________________________________1___________________________________________1________________________
60  ___________________________________________________________________________________________1____________________________________________1_______________________
61  ___________________________________________________________________________________________1_____________________________________________1______________________
62  ___________________________________________________________________________________________1______________________________________________1_____________________
63  ___________________________________________________________________________________________1_______________________________________________1____________________
64  ________________________________________________________________________________111111111111_______________________________________________1____________________
65  _____________________________________________________________________11111111111___________________________________________________________1____________________
66  ____________________________________________________________________1_____________________________________________________________________22____________________
67  ___________________________________________________________________1____________________________________________________________________22_1____________________
68  __________________________________________________________________1__________________________________________________________________222___1____________________
69  _________________________________________________________________1________________________________________________________________222______1____________________
70  ________________________________________________________________1_______________________________________________________________22_________1____________________
71  _______________________________________________________________1__________________________________________________22222222222222___________1____________________
72  ______________________________________________________________1________________________222222222222222222222222222_________________________1____________________
73  _____________________________________________________________1_______________________22____________________________________________________1____________________
74  ____________________________________________________________1_____________________222______________________________________________________1____________________
75  __________________________________________111111111111111111____________________22_________________________________________________________1____________________
76  _________________________________________1______________________________22222222___________________________________________________________1____________________
77  _________________________________________1____________________________22___________________________________________________________________1____________________
78  ________________________________________1____________________________2_____________________________________________________________________1____________________
79  _______________________________________1____________________________2______________________________________________________________________1____________________
80  _______________________________________1__________________________22_______________________________________________________________________1____________________
81  __________________________1111111111111_________________________22_________________________________________________________________________1____________________
82  _________________________1____________________________________22___________________________________________________________________________1____________________
83  11111____________________1__________________________________22_____________________________________________________________________________1____________________
84  _____11__________11111111_________________________________22_______________________________________________________________________________1____________________
85  _______11______11_________________________________22222222_________________________________________________________________________________1____________________
86  _________111111_________________________________22_________________________________________________________________________________________1____________________
87  ______________________________________________22___________________________________________________________________________________________1____________________
88  ___________________________________________111_____________________________________________________________________________________________1____________________
89  ______________________________________________1111_________________________________________________________________________________________1____________________
90  __________________________________________________11111____________________________________________________________________________________1____________________
91  _______________________________________________________111111111___________________________________________________________________________1____________________
92  ________________________________________________________________1111111111_________________________________________________________________1____________________
93  __________________________________________________________________________11111111_________________________________________________________1____________________
94  __________________________________________________________________________________11111111_________________________________________________1____________________
95  __________________________________________________________________________________________11111111_________________________________________1____________________
96  22222222222222222222______________________________________________________________________________11111____________________________________1____________________
97  ____________________22_________________________________________________________________________________11__________________________________1____________________
98  ______________________22_________________________________________________________________________________11________________________________1____________________
99  ________________________22_________________________________________________________________________________11______________________________1____________________
100 __________________________22_________________________________________________________________________________11____________________________1____________________
101 ____________________________22222______________________________________________________________________________11__________________________1____________________
102 _________________________________222222222222____________________________________________________________________11________________________1____________________
103 _____________________________________________22____________________________________________________________________11______________________1____________________
104 _______________________________________________22____________________________________________________________________111111111111__________1____________________
105 _________________________________________________22______________________________________________________________________________11________1____________________
106 ___________________________________________________2_______________________________________________________________________________11______1____________________
107 ___________________________________________________2___________________1_____________________________________________________________11____1____________________
108 ____________________________________________________2_________________111111111111111111111111111111111111111111_______________________11__1____________________
109 ____________________________________________________2____________________1______________________________________1________________________111____________________
110 _____________________________________________________2____________________11____________________________________1__________________________11___________________
111 _____________________________________________________2______________________1____________________________________1___________________________11_________________
112 ______________________________________________________2______________________1____________________________________1____________________________11_______________
113 _______________________________________________________22____1________________11___________________________________1_____________________________1______________
114 _________________________________________________________22221_________________1___________________________________1_____________________________1______________
115 ____________________________________________________________1__________________1____________________________________1____________________________1______________
116 ____________________________________________________________1__________________11111111111___________________________1___________________________1______________
117 11111111111111111___________________________________________1_____________________________111111111111________________1__________________________1______________
118 ________________1_________________________________________11__________________________________________11______________1__________________________1______________
119 _________________1_______________________________________1______________________________________________11111______11111_________________________1______________
120 _________________1______________________________________1____________________________________________________111111_____________________________1_______________
121 __________________1___________________________________11_______________________________________________________________________________________1________________
122 __________________1__________________________________1________________________________________________________________________________________1_________________
123 ___________________1_______________________________11________________________________________________________________________________________1__________________
124 ___________________1______________________________1__________________________________________________________________________________________1__________________
125 ____________________11___________________________1__________________________________________________________________________________________1___________________
126 ______________________11_______________________11__________________________________________________________________________________________1____________________
127 ________________________11____________________1___________________________________________________________________________________________1_____________________
128 __________________________11________________11__________________________________________________________________________________________11______________________
129 ____________________________11_____________1___________________________________________11111111111111_________________________________11________________________
130 ______________________________1111________1____________________________________11111111______________1111111_________________________1__________________________
131 __________________________________1111__11____________________________________1_____________________________1________________________1__________________________
132 ______________________________________11_____________________________________1_______________________________1______________________1___________________________
133 ____________________________________________________________________________1________________________________1_____________________1____________________________
134 ___________________________________________________________________________1__________________________________1___________________1_____________________________
135 _________________________________________________________________________11___________________________________1___________________1_____________________________
136 ________________________________________________________________________1_____________________________________1__________________11_____________________________
137 _______________________________________________________________________1______________________________________1____________________1111_________________________
138 ______________________________________________________________________1______________________________________1_________________________11_______________________
139 _____________________________________________________________________1______________________________________1___________________________1_______________________
140 ____________________________________________________________________1______________________________________1____________________________1_______________________
141 ___________________________________________________________________1_____________________________________11______________________________1______________________
142 ___________________________________________________________________1___________________________________11________________________________1______________________
143 ___________________________________________________________________1______________________________11111__________________________________1______________________
144 ___________________________________________________________________1__________________________1111_______________________________________11_____________________
145 ____________________________________________________________________11______________________11_____________________________________________111__________________
146 ______________________________________________________________________11__________________11__________________________________________________111_______________
147 ________________________________________________________________________1_______________11_______________________________________________________11_____________
148 _________________________________________________________________________11___________11___________________________________________________________1____________
149 ___________________________________________________________________________11____11111_____________________________________________________________1____________
150 _____________________________________________________________________________1111___________________________________________________________________1___________
151 ____________________________________________________________________________________________________________________________________________________1___________
152 _____________________________________________________________________________________________________________________________________________________1__________
153 _____________________________________________________________________________________________________________________________________________________1__________
154 ______________________________________________________________________________________________________________________________________________________1_________
155 ______________________________________________________________________________________________________________________________________________________1_________
156 _______________________________________________________________________________________________________________________________________________________1________
157 _______________________________________________________________________________________________________________________________________________________1________
158 _______________________________________________________________________________________________________________________________________________________1________
159 _______________________________________________________________________________________________________________________________________________________1________
160 _______________________________________________________________________________________________________________________________________________________1________
161 _______________________________________________________________________________________________________________________________________________________1________
162 ________________________________________________________________________________________________________________________________________________________1_______
163 ________________________________________________________________________________________________________________________________________________________1_______
164 ________________________________________________________________________________________________________________________________________________________1_______
165 ________________________________________________________________________________________________________________________________________________________1_______
166 ________________________________________________________________________________________________________________________________________________________1_______
167 ________________________________________________________________________________________________________________________________________________________1_______
