    0         10        20        30        40        50        60        70        80        90        100       110       120       130       140       150
    0123456789012345678901234567890123456789012345678901234567890123456789012345678901234567890123456789012345678901234567890123456789012345678901234567890123456789
0   ________________________________________________________________________________________________________________________________________________________________
1   ________________________________________________________________________________________________________________________________________________________________
2   ________________________________________________________________________________________________________________________________________________________________
3   ________________________________________________________________________________________________________________________________________________________________
4   ________________________________________________________________________________________________________________________________________________________________
5   ________________________________________________________________________________________________________________________________________________________________
6   ________________________________________________________________________________________________________________________________________________________________
7   ________________________________________________________________________________________________________________________________________________________________
8   ________________________________________________________________________________________________________________________________________________________________
9   ________________________________________________________________________________________________________________________________________________________________
10  ________________________________________________________________________________________________________________________________________________________________
11  ________________________________________________________________________________________________________________________________________________________________
12  ________________________________________________________________________________________________________________________________________________________________
13  ________________________________________________________________________________________________________________________________________________________________
14  ________________________________________________________________________________________________________________________________________________________________
15  ________________________________________________________________________________________________________________________________________________________________
16  ________________________________________________________________________________________________________________________________________________________________
17  ________________________________________________________________________________________________________________________________________________________________
18  ________________________________________________________________________________________________________________________________________________________________
19  ________________________________________________________________________________________________________________________________________________________________
20  ________________________________________________________________________________________________________________________________________________________________
21  ________________________________________________________________________________________________________________________________________________________________
22  ________________________________________________________________________________________________________________________________________________________________
23  ________________________________________________________________________________________________________________________________________________________________
24  ________________________________________________________________________________________________________________________________________________________________
25  ________________________________________________________________________________________________________________________________________________________________
26  ________________________________________________________________________________________________________________________________________________________________
27  ________________________________________________________________________________________________________________________________________________________________
28  ________________________________________________________________________________________________________________________________________________________________
29  ________________________________________________________________________________________________________________________________________________________________
30  ________________________________________________________________________________________________________________________________________________________________
31  _____________________________________________________________________________________A__________________________________________________________________________
32  ________________________________________________________________________________________________________________________________________________________________
33  ________________________________________________________________________________________________________________________________________________________________
34  ________________________________________________________________________________________________________________________________________________________________
35  ________________________________________________________________________________________________________________________________________________________________
36  ________________________________________________________________________________________________________________________________________________________________
37  ________________________________________________________________________________________________________________________________________________________________
38  ________________________________________________________________________________________________________________________________________________________________
39  ________________________________________________________________________________________________________________________________________________________________
40  ________________________________________________________________________________________________________________________________________________________________
41  ________________________________________________________________________________________________________________________________________________________________
42  ________________________________________________________________________________________________________________________________________________________________
43  ________________________________________________________________________________________________________________________________________________________________
44  ________________________________________________________________________________________________________________________________________________________________
45  ________________________________________________________________________________________________________________________________________________________________
46  ________________________________________________________________________________________________________________________________________________________________
47  ________________________________________________________________________________________________________________________________________________________________
48  ________________________________________________________________________________________________________________________________________________________________
49  ________________________________________________________________________________________________________________________________________________________________
50  ________________________________________________________________________________________________________________________________________________________________
51  ________________________________________________________________________________________________________________________________________________________________
52  ________________________________________________________________________________________________________________________________________________________________ HORIZON
53  ________________________________________________________________________________________________________________________________________________________________
54  ________________________________________________________________________________________________________________________________________________________________
55  ________________________________________________________________________________________________________________________________________________________________
56  ________________________________________________________________________________________________________________________________________________________________
57  ________________________________________________________________________________________________________________________________________________________________
58  ________________________________________________________________________________________________________________________________________________________________
59  ________________________________________________________________________________________________________________________________________________________________
60  ________________________________________________________________________________________________________________________________________________________________
61  ________________________________________________________________________________________________________________________________________________________________
62  ________________________________________________________________________________________________________________________________________________________________
63  ________________________________________________________________________________________________________________________________________________________________
64  ________________________________________________________________________________________________________________________________________________________________
65  ________________________________________________________________________________________________________________________________________________________________
66  ________________________________________________________________________________________________________________________________________________________________
67  ________________________________________________________________________________________________________________________________________________________________
68  ________________________________________________________________________________________________________________________________________________________________
69  ________________________________________________________________________________________________________________________________________________________________
70  ________________________________________________________________________________________________________________________________________________________________
71  __________________________________________________11111111111111111111111111111111111111111111111111111111111111111111111111111111111111111111111111111111111111
72  ________________________________________________11______________________________________________________________________________________________________________
73  ______________________________________________11________________________________________________________________________________________________________________
74  _____________________________________________1__________________________________________________________________________________________________________________
75  ___________________________________________1111111______________________________________________________________________________________________________________
76  _________________________________________11__1___1______________________________________________________________________________________________________________
77  ________________________________________1____1___1______________________________________________________________________________________________________________
78  _____________________________________11111___1___1______________________________________________________________________________________________________________
79  ____________________________________11___1___1___1______________________________________________________________________________________________________________
80  ___________________________________1_1___1___1___1______________________________________________________________________________________________________________
81  11111111111111111111111__________11__1___1___1___1______________________________________________________________________________________________________________
82  __1___1___1___1___1___1________111___1___1___1___1______________________________________________________________________________________________________________
83  __1___1___1___1___1___1_______1__1___1___1___1___1_____________________________________11_______________________1111111111111111111111__________________________
84  11111111111___1___1___1_______1111___1___1___1___1_______________________________1111116666666666666666___111111______________________1111_______________1111111
85  ___________111111111111__________11111___11111___11111111111111_________________1______________________111_B______________________________1111__________1_______
86  ______________________________________11111111111______________11111111111______1_____________________________________________________________1111____11________
87  __________________________________________________________________________111111__________________________________________________________________1111__________
88  ________________________________________________________________________________________________________________________________________________________________
89  ________________________________________________________________________________________________________________________________________________________________
90  ________________________________________________________________________________________________________________________________________________________________
91  ________________________________________________________________________________________________________________________________________________________________
92  __________________________________________________________________111111________________________________________________________________________________________
93  ________________________________________________________1111111111__1___11______________________________________________________________________________________
94  __________________________________________________111111_11__11111111___1_11____________________________________________________________________________________
95  _________________________________________________11111111_1_1__1111111__1__11___________________________________________________________________________________
96  ______________________________________________________1_1__1_11_____11_1_11_____________________________________________________________________________________
97  _____________________________________________________1_1___11________111_1______________________________________________________________________________________
98  ____________________________________________________1__1_11__________11_1_______________________________________________________________________________________
99  _____________________________________________________1_11_____________1_1_______________________________________________________________________________________
100 _____________________________________________________11_______________1_1_______________________________________________________________________________________
101 _______________________________________________________________________1________________________________________________________________________________________
102 _______________________________________________________________________1________________________________________________________________________________________
103 ________________________________________________________________________________________________________________________________________________________________
104 ________________________________________________________________________________________________________________________________________________________________
105 ________________________________________________________________________________________________________________________________________________________________
106 ________________________________________________________________________________________________________________________________________________________________
107 _______________________________________________________________________________________________11_________________111111_1111111111111111111____________________
108 _____________________________________________________________________________________________111111_____________________11111111111_____11______________________
109 ___________________________________________________________________________________________________________________________________11111________________________
110 ________________________________________________________________________________________________________________________________________________________________
111 ________________________________________________________________________________________________________________________________________________________________
112 ________________________________________________________________________________________________________________________________________________________________
113 ________________________________________________________________________________________________________________________________________________________________
114 ________________________________________________________________________________________________________________________________________________________________
115 ________________________________________________________________________________________________________________________________________________________________
116 ________________________________________________________________________________________________________________________________________________________________
117 ________________________________________________________________________________________________________________________________________________________________
118 ________________________________________________________________________________________________________________________________________________________________
119 ________________________________________________________________________________________________________________________________________________________________
120 ________________________________________________________________________________________________________________________________________________________________
121 ________________________________________________________________________________________________________________________________________________________________
122 ________________________________________________________________________________________________________________________________________________________________
123 ________________________________________________________________________________________________________________________________________________________________
124 ________________________________________________________________________________________________________________________________________________________________
125 ________________________________________________________________________________________________________________________________________________________________
126 ________________________________________________________________________________________________________________________________________________________________
127 11111111111111111111111111111___________________________________________________________________________________________________________________________________
128 _____________________________11_________________________________________________________________________________________________________________________________
129 _______________________________11_______________________________________________________________________________________________________________________________
130 _________________________________11_____________________________________________________________________________________________________________________________
131 _______________1111___111_________11____________________________________________________________________________________________________________________________
132 111111111111111333311133_111111111______________________________________________________________________________________________________________________________
133 _______________33________333333_________________________________________________________________________________________________________________________________
134 _______________3___________333333_______________________________________________________________________________________________________________________________
135 ______________33_____________3333333____________________________________________________________________________________________________________________________
136 ______________3_______________33333333__________________________________________________________________________________________________________________________
137 ______________3________________3333333333_______________________________________________________________________________________________________________________
138 _______________________________3333333333333____________________________________________________________________________________________________________________
139 ________________________________33333333333333__________________________________________________________________________________________________________________
140 _________________________________33333333333333_________________________________________________________________________________________________________________
141 _________________________________3333333333333333_______________________________________________________________________________________________________________
142 __________________________________3333333333333333_________________________________________________111111111111_________________________________________________
143 __________________________________33333333333333333_____________________________________________1111___________11_______________________________________________
144 __________________________________3333333333333333333_______________________________________________11111111____11______________________________________________
145 11111111111111___________________333333333333333333333______________________________________________________1111________________________________________________
146 ______________11_________________33333333333333333333333________________________________________________________________________________________________________
147 ________________1________________3333333333333333333333333______________________________________________________________________________________________________
148 _________________11______________333333333333333333333333333____________________________________________________________________________________________________
149 ___________________1________________33333333333333333333333333__________________________________________________________________________________________________
150 ____________________11__________________33333333333333333333333_________________________________________________________________________________________________
151 ______________________11__________________33333333333333333333333_______________________________________________________________________________________________
152 ________________________1__________________33333333333333333333333______________________________________________________________________________________________
153 _________________________1__________________33333333333333333333333_____________________________________________________________________________________________
154 __________________________1___________________33333333333333333333333___________________________________________________________________________________________
155 ___________________________11__________________333333333333333333333333_________________________________________________________________________________________
156 _____________________________1__________________3333_333333333333333333333______________________________________________________________________________________
157 ______________________________1_________________3333__3333333333333333333333____________________________________________________________________________________
158 _______________________________111_____________________333333333333333333333333_________________________________________________________________________________
159 __________________________________11111_________________3333333333333333333333333_______________________________________________________________________________
160 _______________________________________111111____________3333333333333333333333333______________________________________________________________________________
161 _____________________________________________11111_______3333333333333333333333333______________________________________________________________________________
162 __________________________________________________111____33333333333333333333333333_____________________________________________________________________________
163 _____________________________________________________1____33333333333333333333333333____________________________________________________________________________
164 _____________________________________________________1____333333333333333333333333333___________________________________________________________________________
165 ______________________________________________________1___333333333333333333333333333___________________________________________________________________________
166 ______________________________________________________1__33333333333333333333333333333__________________________________________________________________________
167 _______________________________________________________1_333333333333333333333333333333_________________________________________________________________________
