    0         10        20        30        40        50        60        70        80        90        100       110       120       130       140       150       
    0123456789012345678901234567890123456789012345678901234567890123456789012345678901234567890123456789012345678901234567890123456789012345678901234567890123456789
0   ________________________________________________________________________________________________________________________________________________________________
1   ________________________________________________________________________________________________________________________________________________________________
2   ________________________________________________________________________________________________________________________________________________________________
3   ________________________________________________________________________________________________________________________________________________________________
4   ________________________________________________________________________________________________________________________________________________________________
5   ________________________________________________________________________________________________________________________________________________________________
6   ________________________________________________________________________________________________________________________________________________________________
7   ________________________________________________________________________________________________________________________________________________________________
8   ________________________________________________________________________________________________________________________________________________________________
9   ________________________________________________________________________________________________________________________________________________________________
10  ________________________________________________________________________________________________________________________________________________________________
11  ________________________________________________________________________________________________________________________________________________________________
12  ________________________________________________________________________________________________________________________________________________________________
13  ________________________________________________________________________________________________________________________________________________________________
14  ________________________________________________________________________________________________________________________________________________________________
15  ________________________________________________________________________________________________________________________________________________________________
16  ________________________________________________________________________________________________________________________________________________________________
17  ________________________________________________________________________________________________________________________________________________________________
18  ________________________________________________________________________________________________________________________________________________________________
19  ________________________________________________________________________________________________________________________________________________________________
20  ________________________________________________________________________________________________________________________________________________________________
21  ________________________________________________________________________________________________________________________________________________________________
22  ________________________________________________________________________________________________________________________________________________________________
23  ________________________________________________________________________________________________________________________________________________________________
24  ________________________________________________________________________________________________________________________________________________________________
25  ________________________________________________________________________________________________________________________________________________________________
26  ________________________________________________________________________________________________________________________________________________________________
27  ________________________________________________________________________________________________________________________________________________________________
28  ________________________________________________________________________________________________________________________________________________________________
29  ________________________________________________________________________________________________________________________________________________________________
30  ________________________________________________________________________________________________________________________________________________________________
31  ________________________________________________________________________________________________________________________________________________________________
32  ________________________________________________________________________________________________________________________________________________________________
33  ________________________________________________________________________________________________________________________________________________________________
34  ________________________________________________________________________________________________________________________________________________________________
35  ________________________________________________________________________________________________________________________________________________________________
36  ________________________________________________________________________________________________________________________________________________________________
37  ________________________________________________________________________________________________________________________________________________________________
38  ________________________________________________________________________________________________________________________________________________________________
39  ________________________________________________________________________________________________________________________________________________________________
40  ________________________________________________________________________________________________________________________________________________________________
41  ________________________________________________________________________________________________________________________________________________________________
42  ________________________________________________________________________________________________________________________________________________________________
43  ________________________________________________________________________________________________________________________________________________________________
44  ________________________________________________________________________________________________________________________________________________________________
45  ________________________________________________________________________________________________________________________________________________________________
46  ________________________________________________________________________________________________________________________________________________________________
47  ________________________________________________________________________________________________________________________________________________________________
48  ________________________________________________________________________________________________________________________________________________________________
49  ________________________________________________________________________________________________________________________________________________________________
50  ________________________________________________________________________________________________________________________________________________________________
51  ________________________________________________________________________________________________________________________________________________________________
52  ________________________________________________________________________________________________________________________________________________________________
53  ________________________________________________________________________________________________________________________________________________________________
54  ________________________________________________________________________________________________________________________________________________________________
55  ________________________________________________________________________________________________________________________________________________________________
56  ________________________________________________________________________________________________________________________________________________________________
57  ________________________________________________________________________________________________________________________________________________________________
58  ________________________________________________________________________________________________________________________________________________________________
59  _____________________1__________________________________________________________________________________________________________________________________________
60  _____________________1__________________________________________________________________________________________________________________________________________
61  _____________________1__________________________________________________________________________________________________________________________________________
62  _____________________1_111111111111111111111111111111111111111111111111111111111111111111111111111111111111111111111111111111111111111111_______________________
63  _____________________1__________________________________________________________________________________________________________________1_______________________
64  _____________________1__________________________________________________________________________________________________________________1_______________________
65  _____________________1__________________________________________________________________________________________________________________1_______________________
66  _____________________1__________________________________________________________________________________________________________________1_______________________
67  _____________________1__________________________________________________________________________________________________________________1_______________________
68  _____________________1__________________________________________________________________________________________________________________1_______________________
69  _____________________1__________________________________________________________________________________________________________________1_______________________
70  _____________________1__________________________________________________________________________________________________________________1_______________________
71  _____________________1__________________________________________________________________________________________________________________1_______________________
72  _____________________1__________________________________________________________________________________________________________________1_______________________
73  _____________________1__________________________________________________________________________________________________________________1_______________________
74  _____________________1__________________________________________________________________________________________________________________1_______________________
75  _____________________1__________________________________________________________________________________________________________________1_______________________
76  _____________________1__________________________________________________________________________________________________________________1_______________________
77  _____________________1__________________________________________________________________________________________________________________1_______________________
78  _____________________1__________________________________________________________________________________________________________________1_______________________
79  _____________________1__________________________________________________________________________________________________________________1_______________________
80  _____________________1__________________________________________________________________________________________________________________1_______________________
81  _____________________1__________________________________________________________________________________________________________________1_______________________
82  _____________________1__________________________________________________________________________________________________________________1_______________________
83  _____________________1__________________________________________________________________________________________________________________1_______________________
84  _____________________1__________________________________________________________________________________________________________________1_______________________
85  _____________________1__________________________________________________________________________________________________________________1_______________________
86  _____________________1__________________________________________________________________________________________________________________1_______________________
87  _____________________1__________________________________________________________________________________________________________________1_______________________
88  _____________________1__________________________________________________________________________________________________________________1_______________________
89  _____________________1__________________________________________________________________________________________________________________1_______________________
90  _____________________1__________________________________________________________________________________________________________________1_______________________
91  _____________________1__________________________________________________________________________________________________________________1_______________________
92  _____________________1__________________________________________________________________________________________________________________1_______________________
93  _____________________1__________________________________________________________________________________________________________________1_______________________
94  _____________________1__________________________________________________________________________________________________________________1_______________________
95  _____________________1__________________________________________________________________________________________________________________1_______________________
96  _____________________1__________________________________________________________________________________________________________________1_______________________
97  _____________________1__________________________________________________________________________________________________________________1_______________________
98  _____________________1__________________________________________________________________________________________________________________1_______________________
99  _____________________1__________________________________________________________________________________________________________________1_______________________
100 _____________________1__________________________________________________________________________________________________________________1_______________________
101 _____________________1__________________________________________________________________________________________________________________1_______________________
102 _____________________1__________________________________________________________________________________________________________________1_______________________
103 _____________________1__________________________________________________________________________________________________________________1_______________________
104 _____________________1__________________________________________________________________________________________________________________1_______________________
105 _____________________1__________________________________________________________________________________________________________________1_______________________
106 _____________________1__________________________________________________________________________________________________________________1_______________________
107 _____________________1__________________________________________________________________________________________________________________1_______________________
108 _____________________1__________________________________________________________________________________________________________________1_______________________
109 _____________________1__________________________________________________________________________________________________________________1_______________________
110 _____________________1__________________________________________________________________________________________________________________1_______________________
111 _____________________1__________________________________________________________________________________________________________________1_______________________
112 _____________________1__________________________________________________________________________________________________________________1_______________________
113 _____________________1______________________________________111111111111111111111111111111111111________________________________________1_______________________
114 _____________________1______________________________________1__________________________________1________________________________________1_______________________
115 _____________________1______________________________________1__________________________________1________________________________________1_______________________
116 _____________________1______________________________________1__________________________________1___1___1____1___________________________1_______________________
117 _____________________1______________________________________1__________________________________1___1___1____1___________________________1_______________________
118 _____________________1______________________________________1__________________________________1___1___1____1___________________________1_______________________
119 _____________________1______________________________________1__________________________________1___1___1____1___________________________1_______________________
120 _____________________1______________________________________1__________________________________1___1___1____1___________________________1_______________________
121 _____________________1______________________________________1__________________________________1___1___1____1___________________________1_______________________
122 _____________________1______________________________________1__________________________________1___1___1____1___________________________1_______________________
123 _____________________1______________________________________1__________________________________1___1___1____1___________________________1_______________________
124 _____________________1__________________________1111111111111__________________________________1___1___1____1___________________________1_______________________
125 _____________________1_________________________1_______________________________________________1___1___1____1___________________________1_______________________
126 _____________________1_________________________1___________1111111111111111111111111111111111111___1___1____1___________________________1_______________________
127 _____________________1________________________1____________1_______________________________________1___1____1___________________________1_______________________
128 _____________________1_______________________1_____________1_______________________________________1___1____1___________________________1_______________________
129 _____________________1________________________1____________1_______________________________________1___1____1___________________________1_______________________
130 _____________________1_______________________1_____________1_______________________________________1___1____1___________________________1_______________________
131 _____________________1_______________________1______________111111111111111111111111111111111111111111111111111_________________________1_______________________
132 _____________________1______________________1__________________________________________________________________1________________________1_______________________
133 _____________________1______________________1__________________________________________________________________1________________________1_______________________
134 _____________________1______________________1___________________________________________________________________1_______________________1_______________________
135 _____________________1_____________________1_____________________________________________________________________1______________________1_______________________
136 _____________________1_____________________1_____________________________________________________________________1______________________1_______________________
137 _____________________1____________________1_______________________________________________________________________1_____________________1_______________________
138 _____________________1____________________1________________________________________________________________________1____________________1_______________________
139 _____________________1____________________1________________________________________________________________________1____________________1_______________________
140 _____________________1___________________1__________________________________________________________________________1___________________1_______________________
141 _____________________1___________________11111111111111111111_11111111111____________________________________________1__________________1_______________________
142 _____________________1__________________________________________________1____________________________________________1__________________1_______________________
143 _____________________1__________________________________________________1__________________________________111111111111_________________1_______________________
144 _____________________1__________________________________________________1___________________________________1___________________________1_______________________
145 _____________________1__________________________________________________1____________________________________1__________________________1_______________________
146 _____________________1__________________________________________________1____________________________________1__________________________1_______________________
147 _____________________1__________________________________________________1_____________________________________1_________________________1_______________________
148 _____________________1__________________________________________________1______________________________________1________________________1_______________________
149 _____________________1_______________1__________________________________1_______________________________________1_______________________1_______________________
150 _____________________1______________1_11111111111111_11111111111111111111_______________________________________1_______________________1_______________________
151 _____________________1_____________1_____________________________________________________________________________1______________________1_______________________
152 _____________________1_____________1______________________________________________________________________________1_____________________1_______________________
153 _____________________1____________11111_11111111111111111111111111111111___________________________________________1____________________1_______________________
154 _____________________1_________________1_______________________________1___________________________________________1____________________1_______________________
155 _____________________1___________________1__________________1__________1____________________________________________1___________________1_______________________
156 _____________________1__________111111111_111111111111111111_11111111111_____________________________________________1__________________1_______________________
157 _____________________1_________1______________________________________________________________________________________1_________________1_______________________
158 _____________________1_________1______________________________________________________________________________________1_________________1_______________________
159 _____________________1________1________________________________________________________________________________________1________________1_______________________
160 _____________________1_______1__________________________________________________________________________________________1_______________1_______________________
161 _____________________1______1____________________________________________________________________________________________1______________1_______________________
162 _____________________1______1____________________________________________________________________________________________1______________1_______________________
163 _____________________1_____1______________________________________________________________________________________________1_____________1_______________________
164 _____________________1____1111111111111111111111111111111111111111_______________1111111111111111111111111111111111111111111____________1_______________________
165 _____________________1__________________________________________1________________1______________________________________________________1_______________________
166 _____________________1__________________________________________1________________1______________________________________________________1_______________________
167 _____________________1_________________________________________1_________________1______________________________________________________1_______________________
