    0         10        20        30        40        50        60        70        80        90        100       110       120       130       140       150       
    0123456789012345678901234567890123456789012345678901234567890123456789012345678901234567890123456789012345678901234567890123456789012345678901234567890123456789
0   ________________________________________________________________________________________________________________________________________________________________
1   ________________________________________________________________________________________________________________________________________________________________
2   ________________________________________________________________________________________________________________________________________________________________
3   ________________________________________________________________________________________________________________________________________________________________
4   ________________________________________________________________________________________________________________________________________________________________
5   ________________________________________________________________________________________________________________________________________________________________
6   ________________________________________________________________________________________________________________________________________________________________
7   ________________________________________________________________________________________________________________________________________________________________
8   ________________________________________________________________________________________________________________________________________________________________
9   ________________________________________________________________________________________________________________________________________________________________
10  ________________________________________________________________________________________________________________________________________________________________
11  ________________________________________________________________________________________________________________________________________________________________
12  ________________________________________________________________________________________________________________________________________________________________
13  ________________________________________________________________________________________________________________________________________________________________
14  ________________________________________________________________________________________________________________________________________________________________
15  ________________________________________________________________________________________________________________________________________________________________
16  ________________________________________________________________________________________________________________________________________________________________
17  ________________________________________________________________________________________________________________________________________________________________
18  ________________________________________________________________________________________________________________________________________________________________
19  ________________________________________________________________________________________________________________________________________________________________
20  ________________________________________________________________________________________________________________________________________________________________
21  ________________________________________________________________________________________________________________________________________________________________
22  ________________________________________________________________________________________________________________________________________________________________
23  ________________________________________________________________________________________________________________________________________________________________
24  ________________________________________________________________________________________________________________________________________________________________
25  ________________________________________________________________________________________________________________________________________________________________
26  ________________________________________________________________________________________________________________________________________________________________
27  ________________________________________________________________________________________________________________________________________________________________
28  ________________________________________________________________________________________________________________________________________________________________
29  ________________________________________________________________________________________________________________________________________________________________
30  ________________________________________________________________________________________________________________________________________________________________
31  ________________________________________________________________________________________________________________________________________________________________
32  ________________________________________________________________________________________________________________________________________________________________
33  ________________________________________________________________________________________________________________________________________________________________
34  ________________________________________________________________________________________________________________________________________________________________
35  ________________________________________________________________________________________________________________________________________________________________
36  ________________________________________________________________________________________________________________________________________________________________
37  ________________________________________________________________________________________________________________________________________________________________
38  ________________________________________________________________________________________________________________________________________________________________
39  ________________________________________________________________________________________________________________________________________________________________
40  ________________________________________________________________________________________________________________________________________________________________
41  ________________________________________________________________________________________________________________________________________________________________
42  ________________________________________________________________________________________________________________________________________________________________
43  ________________________________________________________________________________________________________________________________________________________________
44  ________________________________________________________________________________________________________________________________________________________________
45  ________________________________________________________________________________________________________________________________________________________________
46  ________________________________________________________________________________________________________________________________________________________________
47  ________________111111__________________________________________________________________________________________________________________________________________
48  __________________11____________________________________________________________________________________________________________________________________________
49  ________________________________________________________________________________________________________________________________________________________________
50  ________________________________________________________________________________________________________________________________________________________________
51  ________________________________________________________________________________________________________________________________________________________________
52  ________________________________________________________________________________________________________________________________________________________________
53  ________________________________________________________________________________________________________________________________________________________________
54  ________________________________________________________________________________________________________________________________________________________________
55  ________________________________________________________________________________________________________________________________________________________________
56  ________________________________________________________________________________________________________________________________________________________________
57  ________________________________________________________________________________________________________________________________________________________________
58  ________________________________________________________________________________________________________________________________________________________________
59  ____________________________________________________________________________________________________________________________111111______________________________
60  ______________________________________________________________1111111____________________________________________________111___11_______________________________
61  ____________________________________________________________________________________________________________________________111_________________________________
62  ________________________________________________________________________________________________________________________________________________________________
63  ________________________________________________________________________________________________________________________________________________________________
64  ________________________________________________________________________________________________________________________________________________________________
65  ________________________________________________________________________________________________________________________________________________________________
66  ________________________________________________________________________________________________________________________________________________________________
67  ________________________________________________________________________________________________________________________________________________________________
68  ________________________________________________________________________________________________________________________________________________________________
69  ________________________________________________________________________________________________________________________________________________________________
70  ________________________________________________________________________________________________________________________________________________________________
71  ________________________________________________________________________________________________________________________________________________________1111____
72  _______________________________________________________________________________________________________________________________________________________11___11__
73  _________________________________________________________________________________________________________________________________________________________111____
74  ________________________________________________________________________________________________________________________________________________________________
75  ________________________________________________________________________________________________________________________________________________________________
76  ________________________________________________________________________________________________________________________________________________________________
77  ________________________________________________________________________________________________________________________________________________________________
78  ________________________________________________________________________________________________________________________________________________________________
79  ________________________________________________________________________________________________________________________________________________________________
80  ________________________________________________________________________________________________________________________________________________________________
81  ________________________________________________________________________________________________________________________________________________________________
82  __________________________________________________________________________11111_________________________________________________________________________________
83  _____________________________________________________________________11111_____1111_____________________________________________________________________________
84  ________________________________________________________________11111______________1111_________________________________________________________________________
85  ___________________________________________________________11111_______________________1111_____________________________________________________________________
86  ________________________________________________________111________________________________1111_________________________________________________________________
87  ______________________________________________________11_______________________________________1111_____________________________________________________________
88  _____________________________________________________1_____________________________________________1111_________________________________________________________
89  ___________________________________________________11__________________________________________________1111_____________________________________________________
90  __________________________________________________1________________________________________________________1111_________________________________________________
91  ________________________________________________11_____________________________________________________________1111_____________________________________________
92  ______________________________________________11___________________________________________________________________1111_________________________________________
93  ________111__________________________________1_________________________________________________________________________1111_________________1111111_____________
94  ______11___111_____________________________11_________________________________________________________________________111111111_____________1__1__1_____________
95  _____11_____1111__________________________1___________________________________________________________________________1___1____1111_________1__1__1_____________
96  _______11111______________________________1___________________________________________________________________________1___1___11111111______11_1_11_____________
97  ___________________________________________11_________________________________________________________________________1___1___1___1__1________111_______________
98  _____________________________________________111111___________________________________________________________________1___1___1___1__1__________________________
99  ___________________________________________________11_________________________________________________________________1___1___1___1__1__________________________
100 _____________________________________________________11_____________________1_________________________________________1___1___1___1__1__________________________
101 ____________________________________3__________________1____________________1_________________________________________1___1___1___1__1__________________________
102 ___________________________________33___________________11__________________1__1______________________________________1___1___1___1_1___________________________
103 __________________________________3333____________________11________________1__1______________________________________1___1___1___1_1___________________________
104 ________________________________3333333_____________________1_______________1__1___1__________________________________1___1___1___1_1___________________________
105 _______________________________33333333333___________________11_____________1__1___1__________________________________1___1___1___1_1___________________________
106 ______________________________3333333333333____________________11___________1__1___1_____________________________111__1___1___1___11____________________________
107 ____________________________3333333333333333_____________________11_________1__1___1____________________________1___1111__1___1___11____________________________
108 __________________________3333333333333333333______________________1_______111_1___1____________________________1_______1111111____1____________________________
109 ________________________3333333333333333333333______________________11___11___11___1___________________________1____________1111__1_____________________________
110 ______________________33333333333333333333333333______________________111_______1111___________________________1________________111_____________________________
111 ____________________33333333333333333333333333333________________________111111111111_________________________1_________________________________________________
112 __________________33333333333333333333333333333333__________________________________1_________________________1_________________________________________________
113 _________________3333333333333333333333333333333333_________________________________1________________________1__________________________________________________
114 _______________3333333333333333333333333333333333333________________________________1________________________1__________________________________________________
115 ______________3333333333333333333333333333333333333333______________________________1_1_____________________1___________________________________________________
116 _____________3333333333333333333333333333333333333333333____________________________11_1111_________________1___________________________________________________
117 ___________33333333333333333333333333333333333333333333333__________________________1______111_____________1____________________________________________________
118 __________33333333333333333333333333333333333333333333333333__________________________________1111_________1____________________________________________________
119 _________333333333333333333333333333333333333333333333333333333___________________________________111_____1_____________________________________________________
120 ________333333333333333333333333333333333333333333333333333333333____________________________________1111_1_____________________________________________________
121 ________33333333333333333333333333333333333333333333333333333333333______________________________________11_____________________________________________________
122 _______33333333333333333333333333333333333333333333333333333333333333___________________________________________________________________________________________
123 ______33333333333333333333333333333333333333333333333333333333333333333_________________________________________________________________________________________
124 ______333333333333333333333333333333333333333333333333333333333333333333________________________________________________________________________________________
125 _____333333333333333333333333333333333333333333333333333333333333333333333______________________________________________________________________________________
126 _____3333333333333333333333333333333333333333333333333333333333333333333333_____________________________________________________________________________________
127 _____33333333333333333333333333333333333333333333333333333333333333333333333____________________________________________________________________________________
128 _____3333333333333333333333333333333333333333333333333333333333333333333333333__________________________________________________________________________________
129 ____333333333333333333333333333333333333333333333333333333333333333333333333333_________________________________________________________________________________
130 ____33333333333333333333333333333333333333333333333333333333333333333333333333333__33___________________________________________________________________________
131 ___33333333333333333333333333333333333333333333333333333333333333333333333333333333333__________________________________________________________________________
132 ___33333333333333333333333333333333333333333333333333333333333333333333333333333333333__________________________________________________________________________
133 ___333333333333333333333333333333333333333333333333333333333333333333333333333333333333_________________________________________________________________________
134 ___33333333333333333333333333333333333333333333333333333333333333333333333333333333333__________________________________________________________________________
135 ___333333333333333333333333333333333333333333333333333333333333333333333333333333333____________________________________________________________________________
136 ____333333333333333333333333333333333333333333333333333333333333333333333333333333______________________________________________________________________________
137 ____3333333333333333333333333333333333333333333333333333333333333333333333333333________________________________________________________________________________
138 _____3333333333333333333333333333333333333333333333333333333333333333333333333__________________________________________________________________________________
139 _____33333333333333333333333333333333333333333333333333333333333333333333333____________________________________________________________________________________
140 ________333333333333333333333333333333333333333333333333333333333333333333______________________________________________________________________________________
141 ______________3333333333333333333333333333333333333333333333333333333333________________________________________________________________________________________
142 _________________33333333333333333333333333333333333333333333333333333__________________________________________________________________________________________
143 __________________333333333333333333333333333333333333333333333333333______________________________________________________________________________1111_________
144 ___________________3333333333333333333333333333333333333333333333333______________________________________________________________________________1__1__________
145 ____________________33333333333333333333333333333333333333333333333_______________________________________________________________________________1__1__________
146 _____________________3333333333333333333333333333333333333333333333________________________________________________________________________________11___________
147 ______________________33333333333333333333333333333333333333333333______________________________________________________________________________________________
148 ________________________33333333333333333333333333333333333333333_______________________________________________________________________________________________
149 _________________________333333333333333333333333333333333333333________________________________________________________________________________________________
150 __________________________3333333333333333333333333333333333333_________________________________________________________________________________________________
151 ____________________________3333333333333333333333333333333333__________________________________________________________________________________________________
152 ______________________________33333333333333333333333333333333__________________________________________________________________________________________________
153 ________________________________33333333333333333333333333333___________________________________________________________________________________________________
154 __________________________________33333333333333333333333333____________________________________________________________________________________________________
155 ____________________________________33333333333333333333333_____________________________________________________________________________________________________
156 ______________________________________33333333333333333333______________________________________________________________________________________________________
157 _______________________________________33333333333333333________________________________________________________________________________________________________
158 ________________________________________33___333333333__________________________________________________________________________________________________________
159 _____________________________________________33333333___________________________________________________________________________________________________________
160 ______________________________________________3__33_____________________________________________________________________________________________________________
161 ________________________________________________________________________________________________________________________________________________________________
162 ________________________________________________________________________________________________________________________________________________________________
163 ________________________________________________________________________________________________________________________________________________________________
164 ________________________________________________________________________________________________________________________________________________________________
165 ________________________________________________________________________________________________________________________________________________________________
166 ________________________________________________________________________________________________________________________________________________________________
167 ________________________________________________________________________________________________________________________________________________________________
