    0         10        20        30        40        50        60        70        80        90        100       110       120       130       140       150       
    0123456789012345678901234567890123456789012345678901234567890123456789012345678901234567890123456789012345678901234567890123456789012345678901234567890123456789
0   ____________________________________________________11111111111111111111111111__________________________________________________________________________________
1   ____________________________________________________1________________________1__________________________________________________________________________________
2   ____________________________________________________1_______________________1___________________________________________________________________________________
3   ____________________________________________________1_______________________1___________________________________________________________________________________
4   ____________________________________________________1_______________________1___________________________________________________________________________________
5   ____________________________________________________1_______________________1___________________________________________________________________________________
6   ____________________________________________________1______________________1____________________________________________________________________________________
7   ____________________________________________________1______________________1____________________________________________________________________________________
8   ____________________________________________________1______________________1____________________________________________________________________________________
9   ____________________________________________________1______________________1____________________________________________________________________________________
10  ____________________________________________________1_____________________1_____________________________________________________________________________________
11  ____________________________________________________1_____________________1_____________________________________________________________________________________
12  ____________________________________________________1_____________________1_____________________________________________________________________________________
13  ____________________________________________________1_____________________1_____________________________________________________________________________________
14  ____________________________________________________1____________________1______________________________________________________________________________________
15  ____________________________________________________1____________________1______________________________________________________________________________________
16  ____________________________________________________1____________________1______________________________________________________________________________________
17  ____________________________________________________1____________________1______________________________________________________________________________________
18  ____________________________________________________1___________________1_______________________________________________________________________________________
19  ____________________________________________________1___________________1_______________________________________________________________________________________
20  ____________________________________________________1___________________1_______________________________________________________________________________________
21  ____________________________________________________1___________________1_______________________________________________________________________________________
22  ____________________________________________________1__________________1________________________________________________________________________________________
23  ____________________________________________________1__________________1________________________________________________________________________________________
24  ____________________________________________________1__________________1________________________________________________________________________________________
25  ____________________________________________________1__________________1________________________________________________________________________________________
26  ____________________________________________________1_________________1_________________________________________________________________________________________
27  ____________________________________________________1_________________1_________________________________________________________________________________________
28  ____________________________________________________1_________________1_________________________________________________________________________________________
29  ____________________________________________________1_________________1_________________________________________________________________________________________
30  ____________________________________________________1________________1__________________________________________________________________________________________
31  ____________________________________________________1________________1__________________________________________________________________________________________
32  ____________________________________________________1________________1__________________________________________________________________________________________
33  ____________________________________________________1________________1__________________________________________________________________________________________
34  ____________________________________________________1_______________1___________________________________________________________________________________________
35  ____________________________________________________1_______________1___________________________________________________________________________________________
36  ____________________________________________________1_______________1___________________________________________________________________________________________
37  ____________________________________________________1_______________1___________________________________________________________________________________________
38  ____________________________________________________1______________1____________________________________________________________________________________________
39  ____________________________________________________1______________1____________________________________________________________________________________________
40  ____________________________________________________1______________1____________________________________________________________________________________________
41  ____________________________________________________1______________1____________________________________________________________________________________________
42  ___________________________________________________1______________1_____________________________________________________________________________________________
43  ___________________________________________________1______________1_____________________________________________________________________________________________
44  __________________________________________________1_______________1_____________________________________________________________________________________________
45  __________________________________________________1______________1______________________________________________________________________________________________
46  __________________________________________________1______________1______________________________________________________________________________________________
47  __________________________________________________1______________1______________________________________________________________________________________________
48  _________________________________________________1_______________1______________________________________________________________________________________________
49  _________________________________________________1______________1_______________________________________________________________________________________________
50  _________________________________________________1______________1_______________________________________________________________________________________________
51  _________________________________________________1______________1_______________________________________________________________________________________________
52  ________________________________________________1_______________1_______________________________________________________________________________________________
53  ________________________________________________1______________1________________________________________________________________________________________________
54  ________________________________________________1______________1________________________________________________________________________________________________
55  ________________________________________________1______________1________________________________________________________________________________________________
56  _______________________________________________1_______________1________________________________________________________________________________________________
57  _______________________________________________1______________1_________________________________________________________________________________________________
58  _______________________________________________1______________1_________________________________________________________________________________________________
59  _______________________________________________1______________1_________________________________________________________________________________________________
60  ______________________________________________1_______________1_________________________________________________________________________________________________
61  ______________________________________________1______________1__________________________________________________________________________________________________
62  ______________________________________________1______________1__________________________________________________________________________________________________
63  _____________________________________________1_______________1__________________________________________________________________________________________________
64  _____________________________________________1_______________1__________________________________________________________________________________________________
65  _____________________________________________1______________1___________________________________________________________________________________________________
66  _____________________________________________1______________1___________________________________________________________________________________________________
67  ____________________________________________1_______________1___________________________________________________________________________________________________
68  ____________________________________________1_______________1___________________________________________________________________________________________________
69  ____________________________________________1______________1____________________________________________________________________________________________________
70  ____________________________________________1______________1____________________________________________________________________________________________________
71  ___________________________________________1_______________1____________________________________________________________________________________________________
72  ___________________________________________1_______________1____________________________________________________________________________________________________
73  ___________________________________________1______________1_____________________________________________________________________________________________________
74  ___________________________________________1______________1_____________________________________________________________________________________________________
75  __________________________________________1_______________1_____________________________________________________________________________________________________
76  __________________________________________1_______________1_____________________________________________________________________________________________________
77  __________________________________________1______________1______________________________________________________________________________________________________
78  _________________________________________1_______________1______________________________________________________________________________________________________
79  _________________________________________1_______________1______________________________________________________________________________________________________
80  _________________________________________1_______________1______________________________________________________________________________________________________
81  _________________________________________1______________1_______________________________________________________________________________________________________
82  ________________________________________1_______________1_______________________________________________________________________________________________________
83  ________________________________________1_______________1_______________________________________________________________________________________________________
84  ________________________________________1_______________1_______________________________________________________________________________________________________
85  ________________________________________1______________1________________________________________________________________________________________________________
86  _______________________________________1_______________1________________________________________________________________________________________________________
87  _______________________________________1_______________1________________________________________________________________________________________________________
88  _______________________________________1______________1_________________________________________________________________________________________________________
89  _______________________________________1______________1_________________________________________________________________________________________________________
90  ______________________________________1_______________1_________________________________________________________________________________________________________
91  ______________________________________1_______________1_________________________________________________________________________________________________________
92  ______________________________________1______________1__________________________________________________________________________________________________________
93  ______________________________________1______________1__________________________________________________________________________________________________________
94  _____________________________________1_______________1__________________________________________________________________________________________________________
95  _____________________________________1_______________1__________________________________________________________________________________________________________
96  _____________________________________1______________1___________________________________________________________________________________________________________
97  ____________________________________1_______________1___________________________________________________________________________________________________________
98  ____________________________________1_______________1___________________________________________________________________________________________________________
99  ____________________________________1_______________1___________________________________________________________________________________________________________
100 ____________________________________1______________1____________________________________________________________________________________________________________
101 ___________________________________1_______________1____________________________________________________________________________________________________________
102 ___________________________________1_______________1____________________________________________________________________________________________________________
103 ___________________________________1_______________1____________________________________________________________________________________________________________
104 ___________________________________1______________1_____________________________________________________________________________________________________________
105 __________________________________1_______________1_____________________________________________________________________________________________________________
106 __________________________________1_______________1_____________________________________________________________________________________________________________
107 __________________________________1_______________1_____________111111__________________________________________________________________________________________
108 __________________________________1______________1_____________1______1111111111111111111111111111111___________________________________________________________
109 _________________________________1_______________1_____________1_____________________________________1__________________________________________________________
110 _________________________________1_______________1____________1_______________________________________1_________________________________________________________
111 _________________________________1_______________1___________1________________________________________1_________________________________________________________
112 ________________________________1_______________1____________1_________________________________________11111111_________________________________________________
113 ________________________________1_______________1___________1__________________________________________________1________________________________________________
114 ________________________________1_______________1___________1___________________________________________________1_______________________________________________
115 ________________________________1_______________1__________1_____________________________________________________1______________________________________________
116 _______________________________1_______________1__________1______________________________________________________1______________________________________________
117 _______________________________1_______________1__________1_______________________________________________________1_____________________________________________
118 _______________________________1_______________1_________111_____________________________________________11111111111____________________________________________
119 _______________________________1_______________1____________111111_______________________________________1______________________________________________________
120 ______________________________1_______________1___________________111_____________________________________1_____________________________________________________
121 ______________________________1_______________1____________________1______________________________________1_____________________________________________________
122 ______________________________1_______________1____________________1______________________________________1_____________________________________________________
123 ______________________________1_______________1___________________1________________________________________1____________________________________________________
124 _____________________________1_______________1____________________1________________________________________1____________________________________________________
125 _____________________________1_______________1___________________1_________________________________________1____________________________________________________
126 _____________________________1_______________1_____11____________1__________________________________________1___________________________________________________
127 _____________________________1_______________1____1__1111_______1___________________________________________1111111111111_______________________________________
128 ____________________________1_______________1____1_______1111___1_______________________________________________________1_______________________________________
129 ____________________________1_______________1____1___________111____________111111111111111111111111111__________________1______________________________________
130 __________________________11_________________1__1___________________________1_________________________1__________________1______________________________________
131 _________________________1____________________11___________________________1___________________________1__________________1_____________________________________
132 ________________________1_____________________1____________________________1___________________________1__________________1_____________________________________
133 ________________________1______________________1111________________________1___________________________1___________________1____________________________________
134 _______________________1________________________1_1________________________1____________________________1__________________1____________________________________
135 ______________________1__________________________11_______________________1_____________________________1___________________1___________________________________
136 ______________________1___________________________1_______________________1______________________________1__________________1___________________________________
137 _____________________1____________________________11111___________________1______________________________1___________________1__________________________________
138 ____________________1______________________________1__1___________________1______________________________1___________________1__________________________________
139 ____________________1_______________________________1_1__________________1________________________________1___________________1_________________________________
140 ___________________1_________________________________11__________________1111111111111111111111111111111111___________________1_________________________________
141 __________________1___________________________________1________________________________________________________________________1________________________________
142 _________________1____________________________________11_______________________________________________________________________1________________________________
143 _________________1_____________________________________1111_____________________________________________________________________1_______________________________
144 ________________1_______________________________________1_1_____________________________________________________________________1_______________________________
145 _______________1_________________________________________11______________________________________________________________________1______________________________
146 _______________1__________________________________________1______________________________________________________________________1______________________________
147 ______________111111111111111111111_______________________1111____________________________________________________________________1_____________________________
148 ___________________________________1_______________________1_1____________________________________________________________________1_____________________________
149 ____________________________________11______________________11_____________________________________________________________________1____________________________
150 ______________________________________1______________________1_____________________________________________________________________1____________________________
151 _______________________________________1____________________________________________________________________________________________1___________________________
152 ________________________________________1___________________________________________________________________________________________1___________________________
153 _________________________________________11_________________________________________________________________________________________1___________________________
154 ___________________________________________1_________________________________________________________________________________________1__________________________
155 ____________________________________________1________________________________________________________________________________________1__________________________
156 _____________________________________________1_______________________________________________________________________________________1__________________________
157 ______________________________________________1_______________________________________________________________________________________1_________________________
158 _______________________________________________11_____________________________________________________________________________________1_________________________
159 _________________________________________________1____________________________________________________________________________________1_________________________
160 __________________________________________________1____________________________________________________________________________________1________________________
161 ___________________________________________________1___________________________________________________________________________________1________________________
162 ____________________________________________________11_________________________________________________________________________________1________________________
163 ______________________________________________________1_________________________________________________________________________________1_______________________
164 _______________________________________________________111111111________________111111111111111111111111111111111111111111111111111111111_______________________
165 _______________________________________________________________1________________1_______________________________________________________________________________
166 _______________________________________________________________1________________1_______________________________________________________________________________
167 _______________________________________________________________1________________1_______________________________________________________________________________
