    0         10        20        30        40        50        60        70        80        90        100       110       120       130       140       150       
    0123456789012345678901234567890123456789012345678901234567890123456789012345678901234567890123456789012345678901234567890123456789012345678901234567890123456789
0   ____________________________________________________________________________1___________________________________________________________________________________
1   ____________________________________________________________________________1___________________________________________________________________________________
2   ____________________________________________________________________________1___________________________________________________________________________________
3   ____________________________________________________________________________1___________________________________________________________________________________
4   ____________________________________________________________________________1___________________________________________________________________________________
5   ____________________________________________________________________________1___________________________________________________________________________________
6   ____________________________________________________________________________1___________________________________________________________________________________
7   ____________________________________________________________________________1___________________________________________________________________________________
8   ____________________________________________________________________________1___________________________________________________________________________________
9   ____________________________________________________________________________1___________________________________________________________________________________
10  ____________________________________________________________________________1___________________________________________________________________________________
11  ____________________________________________________________________________1___________________________________________________________________________________
12  ____________________________________________________________________________1___________________________________________________________________________________
13  ____________________________________________________________________________1___________________________________________________________________________________
14  ____________________________________________________________________________1___________________________________________________________________________________
15  ____________________________________________________________________________1___________________________________________________________________________________
16  ____________________________________________________________________________1___________________________________________________________________________________
17  ____________________________________________________________________________1___________________________________________________________________________________
18  ____________________________________________________________________________1___________________________________________________________________________________
19  ____________________________________________________________________________1___________________________________________________________________________________
20  ____________________________________________________________________________1___________________________________________________________________________________
21  ____________________________________________________________________________1___________________________________________________________________________________
22  ____________________________________________________________________________111111111111111111111111111111111111111111111111111111111111111111111111111111111111
23  ________________________________________________________________________________________________________________________________________________________________
24  ________________________________________________________________________________________________________________________________________________________________
25  ________________________________________________________________________________________________________________________________________________________________
26  ________________________________________________________________________________________________________________________________________________________________
27  ________________________________________________________________________________________________________________________________________________________________
28  ________________________________________________________________________________________________________________________________________________________________
29  ________________________________________________________________________________________________________________________________________________________________
30  ________________________________________________________________________________________________________________________________________________________________
31  ________________________________________________________________________________________________________________________________________________________________
32  ________________________________________________________________________________________________________________________________________________________________
33  ________________________________________________________________________________________________________________________________________________________________
34  ________________________________________________________________________________________________________________________________________________________________
35  ____________________________________________________________________________________1___________________________________________________________________________
36  ____________________________________________________________________________________1___________________________________________________________________________
37  ____________________________________________________________________________________1___________________________________________________________________________
38  ____________________________________________________________________________________1___________________________________________________________________________
39  ____________________________________________________________________________________1___________________________________________________________________________
40  ____________________________________________________________________________________1___________________________________________________________________________
41  ____________________________________________________________________________________1___________________________________________________________________________
42  ____________________________________________________________________________________1___________________________________________________________________________
43  ____________________________________________________________________________________1___________________________________________________________________________
44  ____________________________________________________________________________________1___________________________________________________________________________
45  ____________________________________________________________________________________1_______________333_333_333_333_333_333_333_333_333_33_333333333333333333333
46  ____________________________________________________________________________________1_______________333_333_333_333_333_333_333_333_333_33_333333333333333333333
47  ____________________________________________________________________________________1_______________333_333_333_333_333_333_333_333_333_33_333333333333333333333
48  ____________________________________________________________________________________1________________33333333333333333333333333333333333333333333333333333333333
49  ___________________________________________________________________________________1________________333333333333333333333333333333333333333333333333333333333333
50  __________________________________________________________________________________1_________________333333333333333333333333333333333333333333333333333333333333
51  _______________________________________________________________________________111_________________3333333333333333333333333333333333333333333333333333333333333
52  ______________________________________________________________________________1____________________3333333333333333333333333333333333333333333333333333333333333
53  _____________________________________________________________________________1_____________________3333333333333333333333333333333333333333333333333333333333333
54  ______________________________________________________________________________1_____________________333333333333333333333333333333333333333333333333333333333333
55  ______________________________________________________________________________1_____________________333333333333333333333333333333333333333333333333333333333333
56  ______________________________________________________________________________11____________________333333333333333333333333333333333333333333333333333333333333
57  ___________________________________________________________________________111_______________________33333333333333333333333333333333333333333333333333333333333
58  ________________________________________________________________________111__________________________33333333333333333333333333333333333333333333333333333333333
59  _____________________________________________________________________111______________________________3333333333333333333333333333333333333333333333333333333333
60  __________________________________________________________________111_________________________________3333333333333333333333333333333333333333333333333333333333
61  _______________________________________________________________111____________________________________3333333333333333333333333333333333333333333333333333333333
62  _____________________________________________________________11______________________________________33333333333333333333333333333333333333333333333333333333333
63  ___________________________________________________________11________________________________________33333333333333333333333333333333333333333333333333333333333
64  __________________________________________________________1___________________________________________3333333333333333333333333333333333333333333333333333333333
65  _________________________________________________________1____________________________________________3333333333333333333333333333333333333333333333333333333333
66  _________________________________________________________1_____________________________________________333333333333333333333333333333333333333333333333333333333
67  ________________________________________________________1______________________________________________333333333333333333333333333333333333333333333333333333333
68  ___________________________________________________11111________________________________________________33333333333333333333333333333333333333333333333333333333
69  ___________________________________________________1____________________________________________________33333333333333333333333333333333333333333333333333333333
70  __________________________________________________1______________________________________________________3333333333333333333333333333333333333333333333333333333
71  __________________________________________________1________________________________________________________33333333333333333333333333333333333333333333333333333
72  _________________________________________________1_________________________________________________________33333333333333333333333333333333333333333333333333333
73  _________________________________________________1_________________________________________________________33333333333333333333333333333333333333333333333333333
74  ________________________________________________1_________________________________________________________333333333333333333333333333333333333333333333333333333
75  ________________________________________________1_________________________________________________________333333333333333333333333333333333333333333333333333333
76  ________________________________________________1_________________________________________________________333333333333333333333333333333333333333333333333333333
77  _______________________________________________1___________________________________________________________33333333333333333333333333333333333333333333333333333
78  _______________________________________________1___________________________________________________________33333333333333333333333333333333333333333333333333333
79  ______________________________________________1_____________________________________________________________3333333333333333333333333333333333333333333333333333
80  ______________________________________________1_____________________________________________________________3333333333333333333333333333333333333333333333333333
81  _____________________________________________1_______________________________________________________________333333333333333333333333333333333333333333333333333
82  _____________________________________________1_______________________________________________________________333333333333333333333333333333333333333333333333333
83  ____________________________________________1________________________________________________________________333333333333333333333333333333333333333333333333333
84  ____________________________________________1________________________________________________________________333333333333333333333333333333333333333333333333333
85  ___________________________________________1________________________________________________________________3333333333333333333333333333333333333333333333333333
86  ___________________________________________1_______________________________________________________________33333333333333333333333333333333333333333333333333333
87  __________________________________________1_______________________________________________________________333333333333333333333333333333333333333333333333333333
88  __________________________________________1______________________________________________________________3333333333333333333333333333333333333333333333333333333
89  _________________________________________1_______________________________________________________________3333333333333333333333333333333333333333333333333333333
90  _________________________________________1_______________________________________________________________3333333333333333333333333333333333333333333333333333333
91  ________________________________________1_______________________________________________________________33333333333333333333333333333333333333333333333333333333
92  ________________________________________1_______________________________________________________________33333333333333333333333333333333333333333333333333333333
93  ________________________________________1_______________________________________________________________33333333333333333333333333333333333333333333333333333333
94  _________________________________________1_____________________________________________________________333333333333333333333333333333333333333333333333333333333
95  _________________________________________1_____________________________________________________________333333333333333333333333333333333333333333333333333333333
96  ________________________________________1_____________________________________________________________3333333333333333333333333333333333333333333333333333333333
97  _______________________________________1_______________________________________________________________333333333333333333333333333333333333333333333333333333333
98  _______________________________________1________________________________________________________________33333333333333333333333333333333333333333333333333333333
99  ______________________________________1_________________________________________________________________33333333333333333333333333333333333333333333333333333333
100 __________________________________1111___________________________________________________________________3333333333333333333333333333333333333333333333333333333
101 __________________________________1_______________________________________________________________________333333333333333333333333333333333333333333333333333333
102 _________________________________1_________________________________________________________________________33333333333333333333333333333333333333333333333333333
103 _________________________________1___________________________________________________________________________333333333333333333333333333333333333333333333333333
104 ________________________________1_____________________________________________________________________________33333333333333333333333333333333333333333333333333
105 _______________________________1________________________________________________________________________________333333333333333333333333333333333333333333333333
106 _______________________________1________________________________________________________________________________333333333333333333333333333333333333333333333333
107 ______________________________1_________________________________________________________________________________333333333333333333333333333333333333333333333333
108 _____________________________1___________________________________________________________________________________33333333333333333333333333333333333333333333333
109 ____________________________1____________________________________________________________________________________33333333333333333333333333333333333333333333333
110 ___________________________1_____________________________________________________________________________________33333333333333333333333333333333333333333333333
111 _________________________11______________________________________________________________________________________33333333333333333333333333333333333333333333333
112 ________________________1________________________________________________________________________________________33333333333333333333333333333333333333333333333
113 _______________________1_________________________________________________________________________________________33333333333333333333333333333333333333333333333
114 ______________________1_________________________________________________________________________________________333333333333333333333333333333333333333333333333
115 ______________________1_________________________________________________________________________________________333333333333333333333333333333333333333333333333
116 _____________________1__________________________________________________________________________________________333333333333333333333333333333333333333333333333
117 _____________________1__________________________________________________________________________________________333333333333333333333333333333333333333333333333
118 ____________________1___________________________________________________________________________________________333333333333333333333333333333333333333333333333
119 ____________________1__________________________________________________________________________________________3333333333333333333333333333333333333333333333333
120 ___________________1__________________________________________________________________________________________33333333333333333333333333333333333333333333333333
121 ___________________1__________________________________________________________________________________________33333333333333333333333333333333333333333333333333
122 __________________1__________________________________________________________________________________________333333333333333333333333333333333333333333333333333
123 __________________1_________________________________________________________________________________________3333333333333333333333333333333333333333333333333333
124 _________________1_________________________________________________________________________________________33333333333333333333333333333333333333333333333333333
125 _________________1_________________________________________________________________________________________33333333333333333333333333333333333333333333333333333
126 ________________1_________________________________________________________________________________________333333333333333333333333333333333333333333333333333333
127 ________________1________________________________________________________________________________________3333333333333333333333333333333333333333333333333333333
128 _______________1________________________________________________________________________________________33333333333333333333333333333333333333333333333333333333
129 _______________1________________________________________________________________________________________33333333333333333333333333333333333333333333333333333333
130 ______________1________________________________________________________________________________________333333333333333333333333333333333333333333333333333333333
131 ______________1________________________________________________________________________________________333333333333333333333333333333333333333333333333333333333
132 _____________1_________________________________________________________________________________________333333333333333333333333333333333333333333333333333333333
133 _____________1_________________________________________________________________________________________333333333333333333333333333333333333333333333333333333333
134 ____________1__________________________________________________________________________________________333333333333333333333333333333333333333333333333333333333
135 ____________1__________________________________________________________________________________________333333333333333333333333333333333333333333333333333333333
136 ___________1____________________________________________________________________________________________33333333333333333333333333333333333333333333333333333333
137 __________1_____________________________________________________________________________________________33333333333333333333333333333333333333333333333333333333
138 _________1_______________________________________________________________________________________________3333333333333333333333333333333333333333333333333333333
139 ________1________________________________________________________________________________________________3333333333333333333333333333333333333333333333333333333
140 ________1_______________________________________________________________________________________________33333333333333333333333333333333333333333333333333333333
141 _______1________________________________________________________________________________________________33333333333333333333333333333333333333333333333333333333
142 ______1________________________________________________________________________________________________333333333333333333333333333333333333333333333333333333333
143 _____1_________________________________________________________________________________________________333333333333333333333333333333333333333333333333333333333
144 ____1_________________________________________________________________________________________________3333333333333333333333333333333333333333333333333333333333
145 ___1__________________________________________________________________________________________________3333333333333333333333333333333333333333333333333333333333
146 ___1__________________________________________________________________________________________________3333333333333333333333333333333333333333333333333333333333
147 __1___________________________________________________________________________________________________3333333333333333333333333333333333333333333333333333333333
148 _1_____________________________________________________________________________________________________333333333333333333333333333333333333333333333333333333333
149 1_______________________________________________________________________________________________________33333333333333333333333333333333333333333333333333333333
150 ________________________________________________________________________________________________________33333333333333333333333333333333333333333333333333333333
151 _________________________________________________________________________________________________________3333333333333333333333333333333333333333333333333333333
152 __________________________________________________________________________________________________________333333333333333333333333333333333333333333333333333333
153 ___________________________________________________________________________________________________________33333333333333333333333333333333333333333333333333333
154 ____________________________________________________________________________________________________________3333333333333333333333333333333333333333333333333333
155 ____________________________________________________________________________________________________________3333333333333333333333333333333333333333333333333333
156 _____________________________________________________________________________________________________________333333333333333333333333333333333333333333333333333
157 ______________________________________________________________________________________________________________33333333333333333333333333333333333333333333333333
158 ______________________________________________________________________________________________________________33333333333333333333333333333333333333333333333333
159 _______________________________________________________________________________________________________________3333333333333333333333333333333333333333333333333
160 _______________________________________________________________________________________________________________3333333333333333333333333333333333333333333333333
161 _______________________________________________________________________________________________________________3333333333333333333333333333333333333333333333333
162 _______________________________________________________________________________________________________________3333333333333333333333333333333333333333333333333
163 ________________________________________________________________________________________________________________333333333333333333333333333333333333333333333333
164 ________________________________________________________________________________________________________________333333333333333333333333333333333333333333333333
165 ________________________________________________________________________________________________________________333333333333333333333333333333333333333333333333
166 _________________________________________________________________________________________________________________33333333333333333333333333333333333333333333333
167 _________________________________________________________________________________________________________________33333333333333333333333333333333333333333333333
