    0         10        20        30        40        50        60        70        80        90        100       110       120       130       140       150
    0123456789012345678901234567890123456789012345678901234567890123456789012345678901234567890123456789012345678901234567890123456789012345678901234567890123456789
0   ____________________________________________________________________1___________________________________________________________________________________________
1   ___________________________________________________________________1____________________________________________________________________________________________
2   __________________________________________________________________1_____________________________________________________________________________________________
3   _________________________________________________________________1______________________________________________________________________________________________
4   ________________________________________________________________1_______________________________________________________________________________________________
5   _______________________________________________________________1________________________________________________________________________________________________
6   ______________________________________________________________1_________________________________________________________________________________________________
7   ____________________________________________________________11__________________________________________________________________________________________________
8   ___________________________________________________________1____________________________________________________________________________________________________
9   __________________________________________________________1_____________________________________________________________________________________________________
10  _________________________________________________________1______________________________________________________________________________________________________
11  ________________________________________________________1_______________________________________________________________________________________________________
12  _______________________________________________________1________________________________________________________________________________________________________
13  ______________________________________________________1_________________________________________________________________________________________________________
14  _____________________________________________________1__________________________________________________________________________________________________________
15  ____________________________________________________1___________________________________________________________________________________________________________
16  ___________________________________________________1____________________________________________________________________________________________________________
17  __________________________________________________1_____________________________________________________________________________________________________________
18  ________________________________________________11______________________________________________________________________________________________________________
19  _______________________________________________1________________________________________________________________________________________________________________
20  ______________________________________________1_________________________________________________________________________________________________________________
21  _____________________________________________1__________________________________________________________________________________________________________________
22  ____________________________________________1___________________________________________________________________________________________________________________
23  ___________________________________________1____________________________________________________________________________________________________________________
24  __________________________________________1_____________________________________________________________________________________________________________________
25  ________________________________________11______________________________________________________________________________________________________________________
26  _______________________________________1________________________________________________________________________________________________________________________
27  ______________________________________1_________________________________________________________________________________________________________________________
28  _____________________________________1__________________________________________________________________________________________________________________________
29  ____________________________________1___________________________________________________________________________________________________________________________
30  ___________________________________1____________________________________________________________________________________________________________________________
31  __________________________________1_____________________________________________________________________________________________________________________________
32  _________________________________1______________________________________________________________________________________________________________________________
33  ________________________________1_______________________________________________________________________________________________________________________________
34  _______________________________1________________________________________________________________________________________________________________________________
35  ______________________________12222_____________________________________________________________________________________________________________________________
36  _____________________________1_____2222222______________________________________________________________________________________________________________________
37  ___________________________11_____________2222222_______________________________________________________________________________________________________________
38  __________________________1______________________2222222________________________________________________________________________________________________________
39  _________________________1______________________________2222____________________________________________________________________________________________________
40  ________________________1_________________________________2_____________________________________________________________________________________________________ HORIZON
41  _______________________1_________________________________2______________________________________________________________________________________________________
42  ______________________1_________________________________2_______________________________________________________________________________________________________
43  _____________________1__________________________________2_______________________________________________________________________________________________________
44  ____________________1__________________________________2________________________________________________________________________________________________________
45  ___________________1__________________________________2_________________________________________________________________________________________________________
46  __________________1__________________________________2__________________________________________________________________________________________________________
47  _________________1__________________________________2___________________________________________________________________________________________________________
48  ________________1_________________________________22____________________________________________________________________________________________________________
49  _______________1_________________________________2______________________________________________________________________________________________________________
50  ______________1_________________________________2_______________________________________________________________________________________________________________
51  _____________1__________________________________2_______________________________________________________________________________________________________________
52  ____________1___________________________________2_______________________________________________________________________________________________________________
53  ___________1___________________________________2________________________________________________________________________________________________________________
54  __________1____________________________________2________________________________________________________________________________________________________________
55  __________1____________________________________2________________________________________________________________________________________________________________
56  __________1____________________________________2________________________________________________________________________________________________________________
57  _________1____________________________________2_________________________________________________________________________________________________________________
58  _________1____________________________________2_________________________________________________________________________________________________________________
59  _________1____________________________________2_________________________________________________________________________________________________________________
60  _________1___________________________________2__________________________________________________________________________________________________________________
61  ________1____________________________________2__________________________________________________________________________________________________________________
62  ________1____________________________________2__________________________________________________________________________________________________________________
63  ________1___________________________________2___________________________________________________________________________________________________________________
64  ________1___________________________________2___________________________________________________________________________________________________________________
65  _______1____________________________________2___________________________________________________________________________________________________________________
66  _______1___________________________________2____________________________________________________________________________________________________________________
67  _______1___________________________________2____________________________________________________________________________________________________________________
68  _______1__________________________________2_____________________________________________________________________________________________________________________
69  ______1___________________________________2_____________________________________________________________________________________________________________________
70  ______1___________________________________2_____________________________________________________________________________________________________________________
71  ______1__________________________________2______________________________________________________________________________________________________________________
72  ______1__________________________________2______________________________________________________________________________________________________________________
73  ______1_________________________________2_______________________________________________________________________________________________________________________
74  _____1__________________________________2_______________________________________________________________________________________________________________________
75  _____1_________________________________2________________________________________________________________________________________________________________________
76  _____1_________________________________2________________________________________________________________________________________________________________________
77  _____1________________________________2_________________________________________________________________________________________________________________________
78  ____1_________________________________2_________________________________________________________________________________________________________________________
79  ____1_________________________________2_________________________________________________________________________________________________________________________
80  ____1_________________________________2_________________________________________________________________________________________________________________________
81  ____1________________________________2__________________________________________________________________________________________________________________________
82  ___1_________________________________2__________________________________________________________________________________________________________________________
83  ___1_________________________________2__________________________________________________________________________________________________________________________
84  ___1_________________________________2__________________________________________________________________________________________________________________________
85  ___1________________________________2___________________________________________________________________________________________________________________________
86  ___1________________________________2___________________________________________________________________________________________________________________________
87  __1_________________________________2___________________________________________________________________________________________________________________________
88  __1________________________________2____________________________________________________________________________________________________________________________
89  __1_______________________________2_____________________________________________________________________________________________________________________________
90  __1_______________________________2_______________________XXXXXXXXXXXXXXXXXXXXXXXXXXXXXXXXXXXXXXX_______________________________________________________________
91  __1_______________________________2_______________________X_____________________________________X_______________________________________________________________
92  __1_______________________________2_______________________X_____________________________________X_______________________________________________________________
93  _1_________________________________2______________________X_____________________________________X_______________________________________________________________
94  _1_________________________________2______________________X_____________________________________X_______________________________________________________________
95  _1_________________________________2______________________X_____________________________________X_______________________________________________________________
96  _1_________________________________2______________________X_____________________________________X_______________________________________________________________
97  _1_________________________________2______________________X_____________________________________X_______________________________________________________________
98  _1_________________________________2______________________X________________________________1111111111___________________________________________________________
99  _1_________________________________2______________________X____________________________1111_____X____111________________________________________________________
100 _1_________________________________2______________________X________________________1111_________X_______11______________________________________________________
101 _1_________________________________2____________________1111___________________1111_____________X_________111___________________________________________________
102 _1_________________________________2_________________111__X_1_____________11111_________________X____________111________________________________________________
103 _1_________________________________2_______________11_____X__1________1111______________________X_____1111111111111_____________________________________________
104 _1_________________________________2_____________11_______X___1___1111__________________________X____1_____________11___________________________________________
105 _1_________________________________2__________111_________X____111______________________________X____1_______________111________________________________________
106 _1_________________________________2______1111____________X_____________________________________X____1___________1111111111_____________________________________
107 _1_________________________________2____11________________X_____________________________________X____1___________1_________11___________________________________
108 _1_________________________________2__11__________________X_____________________________________X_____11________1____________111________________________________
109 _1__________________________________21____________________XXXXXXXXXXXXXXXXXXXXXXXXXXXXXXXXXXXXXXX_______1_____11________________11______________________________
110 _1__________________________________21___________________________________________________________________11__1____________________1_____________________________
111 _1__________________________________12____________________________shelves__________________________________11______________________1____________________________
112 _1________________________________11_2____________________________(58, 90, 96, 109)_________________________________________________1___________________________
113 _1_______________________________1____2_____________________________________________________________________________________________1___________________________
114 _1_______________________________1____2______________________________________________________________________________________________1__________________________
115 _1______________________________1_____2______________________________________________________________________________________________1__________________________
116 _1______________________________1_____2_______________________________________________________________________________________________1_________________________
117 _1______________________________1_____2_______________________________________________________________________________________________1_________________________
118 _1_____________________________1______2_______________________________________________________________________________________________1_________________________
119 _1_____________________________1______2________________________________________________________________________________________________1________________________
120 _1_____________________________1______2________________________________________________________________________________________________1________________________
121 _1_____________________________1_______2________________________________________________________________________________________________1_______________________
122 _1_____________________________1_______2________________________________________________________________________________________________1_______________________
123 _1_____________________________1________2_______________________________________________________________________________________________1_______________________
124 _1______________________________1_______2________________________________________________________________________________________________1______________________
125 _1______________________________1_______2________________________________________________________________________________________________1______________________
126 _1______________________________1_______2_________________________________________________________________________________________________1_____________________
127 _1______________________________1_______2_________________________________________________________________________________________________1_____________________
128 _1______________________________1_______2_________________________________________________________________________________________________1_____________________
129 _1______________________________1_______2__________________________________________________________________________________________________1____________________
130 _1_______________________________1_______2_________________________________________________________________________________________________1____________________
131 _1_______________________________1________2_________________________________________________________________________________________________1___________________
132 _1________________________________1_______2_________________________________________________________________________________________________1___________________
133 _1________________________________1_______2_____________________________________________________________P_(104,133)__________________________1__________________
134 __1_______________________________1_______2_______________________________________________________________book exit__________________________1__________________
135 __1________________________________1______2__________________________________________________________________________________________________1__________________
136 __1________________________________1_______2__________________________________________________________________________________________________1_________________
137 __1_________________________________1_______2_________________________________________________________________________________________________1_________________
138 __1__________________________________1______2__________________________________________________________________________________________________1________________
139 ___1__________________________________1______2______________________________________________XXXXXXXXXXXXXXXXXXXXXXXXXXXX_______________________1________________
140 ___1___________________________________1______2________________________________1111111111111111111111111111111111111111111111111111111_________1________________
141 ___1____________________________________11____2________________________________1_____________________________________________________1__________1_______________
142 ___1______________________________________11__2________________________________1_____________________________________________________1__________1_______________
143 ___1________________________________________112________________________________1111111111111111111111111111111111111111111111111111111___________1______________
144 ___1__________________________________________2________________________________1_____________________________________________________1___________111111111______
145 ____1_________________________________________2________________________________1_____________spell book_______________________________1__________________1______
146 ____1_________________________________________2________________________________1_____________(92, 139, 119, 139)______________________1__________________1______
147 ____1_________________________________________2________________________________1_______________________________________________________1_________________1______
148 _____1________________________________________2________________________________1_______________________________________________________1_________________1______
149 _____1________________________________________2________________________________1________________________________________________________1________________1______
150 ______1_______________________________________2________________________________1________________________________________________________1_______________1_______
151 ______1_______________________________________2________________________________1________________________________________________________1_______________1_______
152 _______1______________________________________2________________________________1_________________________________________________________1______________1_______
153 ________1_____________________________________2________________________________1_________________________________________________________1______________1_______
154 ________1_____________________________________2________________________________1__________________________________________________________1_____________1_______
155 _________1____________________________________2________________________________1__________________________________________________________1_____________1_______
156 __________1___________________________________2_______________________________1____________________________________________________________1____________1_______
157 __________1___________________________________2_______________________________1____________________________________________________________1___________1________
158 ___________1_________________________________2________________________________1_____________________________________________________________1__________1________
159 ___________1__________________________________2_______________________________1_____________________________________________________________1__________1________
160 ____________1_________________________________2_______________________________1_____________________________________________________________1_________1_________
161 _____________11_______________________________2_______________________________1______________________________________________________________1________1_________
162 _______________1______________________________2_______________________________1______________________________________________________________1_______1__________
163 ________________11____________________________2_______________________________1_______________________________________________________________1_____11__________
164 __________________1___________________________2_______________________________1_______________________________________________________________1___11____________
165 ___________________11_________________________2_______________________________1________________________________________________________________111______________
166 _____________________11111111111111111111111111111____________________________1________________________________________________________________1________________
167 __________________________________________________11111111111111111111111111111_________________________________________________________________________________












