    0         10        20        30        40        50        60        70        80        90        100       110       120       130       140       150       
    0123456789012345678901234567890123456789012345678901234567890123456789012345678901234567890123456789012345678901234567890123456789012345678901234567890123456789
0   ________________________________________________________________________________________________________________________________________________________________
1   ________________________________________________________________________________________________________________________________________________________________
2   ________________________________________________________________________________________________________________________________________________________________
3   ________________________________________________________________________________________________________________________________________________________________
4   ________________________________________________________________________________________________________________________________________________________________
5   ________________________________________________________________________________________________________________________________________________________________
6   ________________________________________________________________________________________________________________________________________________________________
7   ________________________________________________________________________________________________________________________________________________________________
8   ________________________________________________________________________________________________________________________________________________________________
9   ________________________________________________________________________________________________________________________________________________________________
10  ________________________________________________________________________________________________________________________________________________________________
11  ________________________________________________________________________________________________________________________________________________________________
12  ________________________________________________________________________________________________________________________________________________________________
13  ________________________________________________________________________________________________________________________________________________________________
14  ________________________________________________________________________________________________________________________________________________________________
15  ________________________________________________________________________________________________________________________________________________________________
16  ________________________________________________________________________________________________________________________________________________________________
17  ________________________________________________________________________________________________________________________________________________________________
18  ________________________________________________________________________________________________________________________________________________________________
19  ________________________________________________________________________________________________________________________________________________________________
20  ________________________________________________________________________________________________________________________________________________________________
21  ________________________________________________________________________________________________________________________________________________________________
22  ________________________________________________________________________________________________________________________________________________________________
23  ________________________________________________________________________________________________________________________________________________________________
24  ________________________________________________________________________________________________________________________________________________________________
25  ________________________________________________________________________________________________________________________________________________________________
26  ________________________________________________________________________________________________________________________________________________________________
27  ________________________________________________________________________________________________________________________________________________________________
28  ________________________________________________________________________________________________________________________________________________________________
29  ________________________________________________________________________________________________________________________________________________________________
30  ________________________________________________________________________________________________________________________________________________________________
31  ________________________________________________________________________________________________________________________________________________________________
32  ________________________________________________________________________________________________________________________________________________________________
33  ________________________________________________________________________________________________________________________________________________________________
34  ________________________________________________________________________________________________________________________________________________________________
35  ________________________________________________________________________________________________________________________________________________________________
36  ________________________________________________________________________________________________________________________________________________________________
37  ________________________________________________________________________________________________________________________________________________________________
38  ________________________________________________________________________________________________________________________________________________________________
39  ________________________________________________________________________________________________________________________________________________________________
40  ________________________________________________________________________________________________________________________________________________________________
41  ________________________________________________________________________________________________________________________________________________________________
42  ________________________________________________________________________________________________________________________________________________________________
43  ________________________________________________________________________________________________________________________________________________________________
44  ________________________________________________________________________________________________________________________________________________________________
45  ________________________________________________________________________________________________________________________________________________________________
46  ______________________________________________________________________________1___________3333333_33333333333333333333333333333333333333333333333333333333333333
47  ______________________________________________________________________________1____33333333333333333333333333333333333333333333333333333333333333333333333333333
48  ______________________________________________________________________________1_______33333333333333333333333333333333333333333333333333333333333333333333333333
49  ______________________________________________________________________________1_____________33333333333333333333333333333333333333333333333333333333333333333333
50  ______________________________________________________________________________1__________________333333333333333333333333333333333333333333333333333333333333333
51  ______________________________________________________________________________1____________________3333333333333333333333333333333333333333333333333333333333333
52  ______________________________________________________________________________1______________________33333333333333333333333333333333333333333333333333333333333
53  ______________________________________________________________________________1________________________333333333333333333333333333333333333333333333333333333333
54  ______________________________________________________________________________1__________________________3333333333333333333333333333333333333333333333333333333
55  ______________________________________________________________________________1_____________________________3333333333333333333333333333333333333333333333333333
56  ____________________________________________________________111_______________1_______________________________33333333333333333333333333333333333333333333333333
57  __________________________________________________________11___1111___________1_________________________________333333333333333333333333333333333333333333333333
58  _____________________________________________________11111_________11111111111_1___________________________________333333333333333333333333333333333333333333333
59  __________________________________________________________1111111111_________1_1_____________________________________3333333333333333333333333333333333333333333
60  ____________________________________________________________________1111111111_1_______________________________________33333333333333333333333333333333333333333
61  _______________________________________________________________________________1_________________________________________333333333333333333333333333333333333333
62  _______________________________________________________________________________1__________________________________________33333333333333333333333333333333333333
63  ______________________________________________________________________________1____________________________________________3333333333333333333333333333333333333
64  ______________________________________________________________________________1______________________________________________33333333333333333333333333333333333
65  _____________________________________________________________________________1________________________________________________3333333333333333333333333333333333
66  _____________________________________________________________________________1________________________________________________3333333333333333333333333333333333
67  ____________________________________________________________________________1__________________________________________________333333333333333333333333333333333
68  ____________________________________________________________________________1__________________________________________________333333333333333333333333333333333
69  ___________________________________________________________________________1__________________________________________________3333333333333333333333333333333333
70  ___________________________________________________________________________1__________________________________________________3333333333333333333333333333333333
71  __________________________________________________________________________1__________________________________________________33333333333333333333333333333333333
72  _________________________________________________________________________1__________________________________________________333333333333333333333333333333333333
73  ________________________________________________________________________1___________________________________________________333333333333333333333333333333333333
74  ________________________________________________________________________1__________________________________________________3333333333333333333333333333333333333
75  _______________________________________________________________________1__________________________________________________33333333333333333333333333333333333333
76  _______________________________________________________________________1_________________________________________________333333333333333333333333333333333333333
77  ______________________________________________________________________1__________________________________________________333333333333333333333333333333333333333
78  ______________________________________________________________________1_________________________________________________3333333333333333333333333333333333333333
79  _____________________________________________________________________1_________________________________________________33333333333333333333333333333333333333333
80  _____________________________________________________________________1________________________________________________333333333333333333333333333333333333333333
81  ____________________________________________________________________1_________________________________________________333333333333333333333333333333333333333333
82  ____________________________________________________________________1__________________________________________________33333333333333333333333333333333333333333
83  _____________________________________________________________________1_________________________________________________33333333333333333333333333333333333333333
84  _____________________________________________________________________1__________________________________________________3333333333333333333333333333333333333333
85  _____________________________________________________________________1___________________________________________________333333333333333333333333333333333333333
86  ______________________________________________________________________1___________________________________________________33333333333333333333333333333333333333
87  ______________________________________________________________________1_____________________________________________________333333333333333333333333333333333333
88  ______________________________________________________________________1______________________________________________________33333333333333333333333333333333333
89  ______________________________________________________________________1_______________________________________________________3333333333333333333333333333333333
90  _______________________________________________________________________1________________________________________________________33333333333333333333333333333333
91  _______________________________________________________________________1_________________________________________________________3333333333333333333333333333333
92  _______________________________________________11111___________________1___________________________________________________________33333333333333333333333333333
93  ______________________________________111111111_____1__________________1____________________________________________________________3333333333333333333333333333
94  _____________________________111111111______________1__________________1_____________________________________________________________333333333333333333333333333
95  ________________________11111________________________1__________________1_____________________________________________________________33333333333333333333333333
96  _________________________1_________________________111__________________1______________________________________________________________3333333333333333333333333
97  _________________________1111__________________1111_____________________1_______________________________________________________________333333333333333333333333
98  _____________________________11111111______1111_________________________1________________________________________________________________33333333333333333333333
99  _____________________________________111111____________________________1__________________________________________________________________3333333333333333333333
100 _______________________________________________________________________1__________________________________________________________________3333333333333333333333
101 ______________________________________________________________________1_____________________________3_____________________________________3333333333333333333333
102 _____________________________________________________________________1__________________________33333______33____________________________33333333333333333333333
103 _____________________________________________________________________1_____33333_____________3333333________33333_______________________333333333333333333333333
104 __________________________________________________________________111__33333333333333____33333333333________333333333_________________33333333333333333333333333
105 ________________________________________________________11111111113333333333333333333333333333333333___111__3333333333333___________3333333333333333333333333333
106 ______________________________________________________113333333333333333333333333333333333333333333_111___11_3333333333333333___33333333333333333333333333333333
107 ____________________________________________________1133333_3333333333333333333333333333333333333331________1333333333333333333333333333333333333333333333333333
108 ______________________________________________1111113333333___33333333333333333333333333333333333333111___113333333333333333333333333333333333333333333333333333
109 ________________________________________111111_333333333333_____33333333333333_____________333333333333111333333333333333333333333333333333333333333333333333333
110 ___________________________________________3333333333333333_____33333333____________________________333333333333333333333333333333333333333333333333333333333333
111 _______________________________________3333333333333333333______333333______________________________333333333333333333333333333333333333333333333333333333333333
112 _________________________________3333333333333333333333333_______33333_________________________33333333333333333333333333333333333333333333333333333333333333333
113 33333333333______________333333333333333333333333333333333_______333333__________________33333333333333333333333333333333333333333333333333333333333333333333333
114 3333333333333333333333333333333333333333333333333333333333_______33333333_33333______333333333333333333333333333333333333333333333333333333333333333333333333333
115 333333333333333333333333333333333333333333333333333333333________333333333333333333333333333333333333333333_____333333333333333333333333333333333333333333333333
116 333333333333333333333333333333333333333333333333333333333________333333333333333333333333333333333333333__________________33333333333333333333333333333333333333
117 333333333333333333333333333333333333333333333333333333333___111__333333333333333333333333333______________________________33333333333333333333333333333333333333
118 33333333333333333333333333333333333333333333333333333333_111__1_3333333333333333333333333333__________________________333333333333333333333333333333333333333333
119 333333333333333333333333333333333333333333333333333333331______133333333333333333333333333333333333_________________33333333_________333333333333333333333333333
120 33333333333333333333333333333333333333333333333333333333311___113333333333333333333333333333333333333______________3333333_________________333333333333333333333
121 33333333333333333333333333333333333333333333333333333333333111333333333333333333333333333333333333333333______3333333333_____________________3333333333333333333
122 3333333333333333333333333333333333333333333333333333333333333333333333333333333333333333333333333333333333333333333333______________________33333333333333333333
123 33333333333333333333333333333333333333333333333333333333333333333333333333333333333333333333333333____333333333333________________________3333333333333333333333
124 333333333333333333333333333333333333333333333333333333333333333333333333333333333333333333333333________________________________________333333333333333____33333
125 33333333333333333333333333333333333333333333333333333333333333333333333333333333333333____3333________________________________________333333333333____________33
126 3333333333333333333333333333333333333333333333333333333333333333333333333333333333333________________________________________________333333333__________________
127 3333333333333333333333333333333333333333333333333333333_____333333333333333333333333333_____________________________________________33333333____________________
128 3333333333333333333333333333333333333333333333333333_____________333333333333333333333333__________________________________________3333333______________________
129 ________________________33333333333333333333333333_________________333333333333333333333333______________________________________3333333________________________
130 _________________________________________333333______________________333333333333333333333333333________________________________33333333________________________
131 ______________________________________________________________________333333333333333333333333333333__________________________3333333333__3333333__________33333
132 ______________________________________________________________________333333333333333333333333333333333333333333333_______33333333333333333333333333333333333333
133 _______________________________________________________________________3333333333333333333333333333333333333333333333__33333333333333333333333333333333333333333
134 _________________________________________________________________________333333333333333333333333333333333333333333333333333333333333333333333333333333333333333
135 ___________________________________________________________________________3333333333333333333333333333333333333333333333333333333333333333333333333333333333333
136 _____________________________________________________________________________33333333333333333333333333333333333333333333333333333333333333333333333333333333333
137 ______________________________________________________________________________3333333333333333333333333333333333333333333333_____3333333333333333333333333333333
138 ________________________________________________________________________________33333333333____333333333333333333333333________________33333333______33333333333
139 __________________________________________________________________________________333333333_____3333333333333333______________________________________3333333333
140 ______________________________________________________________________________________3333______3333333333______________________________________________33333333
141 _________________________________________________________________________________________________________________________________________________________3333333
142 __________________________________________________________________________________________________________________________________________________________333333
143 _________________________________________________________________________________________111111___________________________________________________________333333
144 ________________________________________________________________________________________111____11_________________________________________________________333333
145 ___________________________________________________________________________________________1111____________________________________________________________33333
146 ___________________________________________________________________________________________________________________________________________________________33333
147 ___________________________________________________________________________________________________________________________________________________________33333
148 ____________________________________________________________________________________________________________________________________________________________3333
149 _____________________________________________________________________________________________________________________________________________________________333
150 _____________________________________________________________________________________________________________________________________________________________333
151 ______________________________________________________________________________________________________________________________________________________________33
152 _______________________________________________________________________________________________________________________________________________________________3
153 ________________________________________________________________________________________________________________________________________________________________
154 ________________________________________________________________________________________________________________________________________________________________
155 ________________________________________________________________________________________________________________________________________________________________
156 ________________________________________________________________________________________________________________________________________________________________
157 ________________________________________________________________________________________________________________________________________________________________
158 ________________________________________________________________________________________________________________________________________________________________
159 ________________________________________________________________________________________________________________________________________________________________
160 ________________________________________________________________________________________________________________________________________________________________
161 ________________________________________________________________________________________________________________________________________________________________
162 ________________________________________________________________________________________________________________________________________________________________
163 ________________________________________________________________________________________________________________________________________________________________
164 ________________________________________________________________________________________________________________________________________________________________
165 ________________________________________________________________________________________________________________________________________________________________
166 ________________________________________________________________________________________________________________________________________________________________
167 ________________________________________________________________________________________________________________________________________________________________
