    0         10        20        30        40        50        60        70        80        90        100       110       120       130       140       150
    0123456789012345678901234567890123456789012345678901234567890123456789012345678901234567890123456789012345678901234567890123456789012345678901234567890123456789
0   ____________________________________________________________________________________________________________________________________11111111111111111___________
1   ___________________________________________________________________________________________________________________________________1_______________1____________
2   __________________________________________________________________________________________________________________________________1_______________1_____________
3   _________________________________________________________________________________________________________________________________1_______________1______________
4   _________________________________________________________________________________________________________________________________1______________1_______________
5   ________________________________________________________________________________________________________________________________1______________1________________
6   _______________________________________________________________________________________________________________________________1_______________1________________
7   ______________________________________________________________________________________________________________________________1_______________1_________________
8   _____________________________________________________________________________________________________________________________1_______________1__________________
9   ____________________________________________________________________________________________________________________________1_______________1___________________
10  ___________________________________________________________________________________________________________________________1_______________1____________________
11  __________________________________________________________________________________________________________________________1_______________1_____________________
12  __________________________________________________________________________________________________________________________1______________1______________________
13  _________________________________________________________________________________________________________________________1______________1_______________________
14  ________________________________________________________________________________________________________________________1______________1________________________
15  _______________________________________________________________________________________________________________________1______________1_________________________
16  ______________________________________________________________________________________________________________________1______________1__________________________
17  _____________________________________________________________________________________________________________________1______________1___________________________
18  ____________________________________________________________________________________________________________________1_______________1___________________________
19  ____________________________________________________________________________________________________________________1______________1____________________________
20  ___________________________________________________________________________________________________________________1______________1_____________________________
21  __________________________________________________________________________________________________________________1______________1______________________________
22  _________________________________________________________________________________________________________________1______________1_______________________________
23  ________________________________________________________________________________________________________________1______________1________________________________
24  _______________________________________________________________________________________________________________1______________1_________________________________
25  ______________________________________________________________________________________________________________1______________1__________________________________
26  ______________________________________________________________________________________________________________1_____________1___________________________________
27  _____________________________________________________________________________________________________________1_____________1____________________________________
28  ____________________________________________________________________________________________________________1_____________1_____________________________________
29  ___________________________________________________________________________________________________________1_____________1______________________________________
30  __________________________________________________________________________________________________________1______________1______________________________________
31  _________________________________________________________________________________________________________1______________1_______________________________________
32  ________________________________________________________________________________________________________1______________1________________________________________
33  _______________________________________________________________________________________________________1______________1_________________________________________
34  _______________________________________________________________________________________________________1_____________1__________________________________________
35  ______________________________________________________________________________________________________1_____________1___________________________________________
36  _____________________________________________________________________________________________________1_____________1____________________________________________
37  ____________________________________________________________________________________________________1_____________1_____________________________________________
38  ___________________________________________________________________________________________________1_____________1______________________________________________
39  __________________________________________________________________________________________________1_____________1_______________________________________________
40  _________________________________________________________________________________________________1_____________1________________________________________________
41  _________________________________________________________________________________________________1____________1_________________________________________________
42  _____________________________________________________________________________________________XXX1XXXXXXXXXXXXX1___upstairs hallway______________________________
43  _____________________________________________________________________________________________X_1_____________1____(93, 42, 109, 44)_____________________________
44  _____________________________________________________________________________________________X166666666666661X__________________________________________________
45  _____________________________________________________________________________________________1_____________1____________________________________________________
46  ____________________________________________________________________________________________1__D__________1_____________________________________________________ D = 95,46
47  ___________________________________________________________________________________________1_____________1______________________________________________________
48  ___________________________________________________________________________________________1____________1_______________________________________________________
49  __________________________________________________________________________________________1____________1________________________________________________________
50  _________________________________________________________________________________________1____________1_________________________________________________________
51  ________________________________________________________________________________________1____________1__________________________________________________________
52  _______________________________________________________________________________________1____________1___________________________________________________________
53  ______________________________________________________________________________________1____________1____________________________________________________________
54  _____________________________________________________________________________________1_____________1____________________________________________________________
55  ____________________________________________________________________________________1_____________1_____________________________________________________________
56  ____________________________________________________________________________________1____________1______________________________________________________________
57  ___________________________________________________________________________________1____________1_______________________________________________________________
58  __________________________________________________________________________________1____________1________________________________________________________________
59  _________________________________________________________________________________1____________1_________________________________________________________________
60  ________________________________________________________________________________1____________1__________________________________________________________________
61  _______________________________________________________________________________1____________1___________________________________________________________________
62  ______________________________________________________________________________1____________1____________________________________________________________________
63  ______________________________________________________________________________1___________1_____________________________________________________________________
64  _____________________________________________________________________________1___________1______________________________________________________________________
65  ____________________________________________________________________________1___________1_______________________________________________________________________
66  ___________________________________________________________________________1____________1_______________________________________________________________________
67  __________________________________________________________________________1____________1________________________________________________________________________
68  _________________________________________________________________________1____________1_________________________________________________________________________
69  ________________________________________________________________________1____________1__________________________________________________________________________
70  ________________________________________________________________________1___________1___________________________________________________________________________
71  _______________________________________________________________________1___________1____________________________________________________________________________
72  ______________________________________________________________________1___________1_____________________________________________________________________________
73  _____________________________________________________________________1___________1______________________________________________________________________________
74  ____________________________________________________________________1___________1_______________________________________________________________________________
75  ___________________________________________________________________1___________1________________________________________________________________________________
76  __________________________________________________________________1___________1_________________________________________________________________________________
77  _________________________________________________________________1___________1__________________________________________________________________________________
78  _________________________________________________________________1___________1__________________________________________________________________________________
79  ________________________________________________________________1___________1___________________________________________________________________________________
80  _______________________________________________________________1___________1____________________________________________________________________________________
81  ______________________________________________________________1___________1_____________________________________________________________________________________
82  _____________________________________________________________1___________1______________________________________________________________________________________
83  ____________________________________________________________1___________1_______________________________________________________________________________________
84  ______________________________________________11111111_____1___________1________________________________________________________________________________________
85  _____________________________________________1________1____1__________1_________________________________________________________________________________________
86  _________________________________________1111_________1___1__________1__________________________________________________________________________________________
87  ________________________________________1______________1_1__________1___________________________________________________________________________________________
88  _______________________________________1________________1__________1____________________________________________________________________________________________
89  ______________________________________1________________6_2________1_____________________________________________________________________________________________
90  ______________________________________1_______________6___2_______1_____________________________________________________________________________________________
91  _____________________________________1_______________6____2______1______________________________________________________________________________________________
92  ____________________________________1_______________6______2____1_______________________________________________________________________________________________
93  ___________________________________1_______________6_______2___1________________________________________________________________________________________________
94  __________________________________1________________6________2_1_________________________________________________________________________________________________
95  _________________________________1_A______________6__________1__________________________________________________________________________________________________
96  _________________________________1__.____________6__________6_1_________________________________________________________________________________________________
97  ________________________________1____.__________6__________6__1_________________________________________________________________________________________________
98  _______________________________1______.________6__________6____1________________________________________________________________________________________________
99  ______________________________133333333.3333331____C______6_____1_______________________________________________________________________________________________
100 _____________________________1__________.______2__.______6_______1___________________________1111111111111111___________________________________________________
101 ____________________________1____________._____2_.______6________1___________________________1______________1___________________________________________________
102 ____________________________1_____________._____2______6__________1__________________________1______________1___________________________________________________
103 ___________________________1_______________.___.2_____6____________1_________________________1______________1___________________________________________________
104 __________________________1_________________._.__2____6_____________1________________________1______________1___________________________________________________
105 _________________________1___________________B___2___6______________1________________________1______________1___________________________________________________
106 ________________________1_________________________2_6________________1_______________________1______________1___________________________________________________
107 _______________________1___________________________1__________________1______________________1______________1___________________________________________________
108 _______________________1__________________________1_1__________________1_____________________1______________1___________________________________________________
109 ______________________1__________________________1___1_________________1_____________________1______________1___________________________________________________
110 _____________________1__________________________1____1__________________1____________________1______________1___________________________________________________
111 ____________________1__________________________1______1__________________1___________________1______________1___________________________________________________
112 ___________________1__________________________1________1__________________1__________________1______________1___________________________________________________
113 __________________1__________________________1__________1_________________1__________________1______________1___________________________________________________
114 __________________1_________________________1___________1__________________1_________________1______________1___________________________________________________
115 _________________1__________________________1____________1__________________1________________1______________1___________________________________________________
116 ________________1__________________________1______________1__________________1_______________1XXXXXXXXXXXXXX1XX___wizard office_________________________________
117 _______________1__________________________1________________1_________________1_______________1______________1_X___(93, 116, 110, 118)___________________________
118 ______________1__________________________1_________________1__________________1______________1XXXXXXXXXXXXXX1XX_________________________________________________
119 _____________1__________________________1___________________1__________________1_____________1______________1___________________________________________________
120 _____________1_________________________1_____________________1__________________1____________1______________1___________________________________________________
121 ____________1_________________________1_______________________1_________________1____________1___C__________1___________________________________________________ C = 97,121
122 ___________111111111111111111111111111_________________________1_________________1111111111111______________11111111111_________________________________________
123 _______________________________________________________________1_______________________________________________________1________________________________________
124 ________________________________________________________________1______________________________________________________1________________________________________
125 _________________________________________________________________1______________________________________________________1_______________________________________
126 __________________________________________________________________1______________________________________________________1______________________________________
127 __________________________________________________________________1_______________________________________________________1_____________________________________
128 ___________________________________________________________________1______________________________________________________1_____________________________________
129 ____________________________________________________________________1______________________________________________________1____________________________________
130 _____________________________________________________________________1______________________________________________________1___________________________________
131 ______________________________________________________________________1______________________________________________________1__________________________________
132 ______________________________________________________________________1______________________________________________________1__________________________________
133 _______________________________________________________________________1______________________________________________________1_________________________________
134 ________________________________________________________________________1______________________________________________________111111111111111111111111111111111
135 _________________________________________________________________________1_________________________________________________________X________X__________________1
136 _________________________________________________________________________1_________________________________________________________X________X__dining area_____1
137 __________________________________________________________________________1_____________________S (96,137)_________________________X________X__(131, 134,______1
138 ___________________________________________________________________________1______________________start-position___________________X________X___140, 144)______1
139 ____________________________________________________________________________1______________________________________________________X________X__________________1
140 ____________________________________________________________________________1___________________________________________________B__X________X__________________1 B = 128,140
141 _____________________________________________________________________________1_____________________________________________________X________X__________________1
142 ______________________________________________________________________________1111_________________________________________________X________X__________________1
143 _________________________________________________________________________________1_________________________________________________X________X__________________1
144 _________________________________________________________________________________1_________________________________________________XX111111111111111111111111111
145 ____________________________________________________________1111111111111111111111____________________________________________________1_________________________
146 ___________________________________________________________1__________________________________________________________________________1_________________________
147 ___________________________________________________________1___________________________________________________________________________1________________________
148 __________________________________________________________1____________________________________________________________________________1________________________
149 __________________________________________________________1_____________________________________________________________________________1_______________________
150 __________________________________________________________1______________________________________________________________________________1______________________
151 __________________________________________________________1______________________________________________________________________________1______________________
152 __________________________________________________________1_______________________________________________________________________________1_____________________
153 __________________________________________________________1_______________________________________________________________________________1_____________________
154 __________________________________________________________1________________________________________________________________________________1____________________
155 __________________________________________________________1________________________________________________________________________________1____________________
156 __________________________________________________________1_________________________________________________________________________________1___________________
157 _________________________________________________________1__________________________________________________________________________________1___________________
158 _________________________________________________________1___________________________________________________________________________________1__________________
159 _________________________________________________________1___________________________________________________________________________________1__________________
160 _________________________________________________________1____________________________________________________________________________________1_________________
161 _________________________________________________________1____________________________________________________________________________________1_________________
162 _________________________________________________________1_____________________________________________________________________________________1________________
163 _________________________________________________________1_____________________________________________________________________________________1________________
164 _________________________________________________________1______________________________________(95,165)________________________________________1_______________
165 _________________________________________________________1_____________________________________A________________________________________________1_______________
166 _________________________________________________________111111111111111111111111111111111111______________111111111111111111111111111111111111111______________
167 ____________________________________________________________________________________________1_______________1___________________________________________________









