    0         10        20        30        40        50        60        70        80        90        100       110       120       130       140       150       
    0123456789012345678901234567890123456789012345678901234567890123456789012345678901234567890123456789012345678901234567890123456789012345678901234567890123456789
0   ________________________________________________________________________________________________________________________________________________________________
1   ________________11______________________________________________________________________________________________________________________________________________
2   _________________11_____________________________________________________________________________________________________________________________________________
3   _333______________11____________________________________________________________________________________________________________________________________________
4   _333_______________11___________________________________________________________________________________________________________________________________________
5   _233________________11__________________________________________________________________________________________________________________________________________
6   1323_________________11_________________________________________________________________________________________________________________________________________
7   _1323333______________11________________________________________________________________________________________________________________________________________
8   __132333_______________11_______________________________________________________________________________________________________________________________________
9   ___13233________________11______________________________________________________________________________________________________________________________________
10  ____1323_________________11_____________________________________________________________________________________________________________________________________
11  ____31323333______________11____________________________________________________________________________________________________________________________________
12  _____3132333_______________11___________________________________________________________________________________________________________________________________
13  _____3313233________________11__________________________________________________________________________________________________________________________________
14  _____3331323_________________11_________________________________________________________________________________________________________________________________
15  _____33331323333______________11________________________________________________________________________________________________________________________________
16  ______3333132333_______________11_______________________________________________________________________________________________________________________________
17  _______333313233________________11______________________________________________________________________________________________________________________________
18  _________3331323_________________11_____________________________________________________________________________________________________________________________
19  _________33331323333______________11____________________________________________________________________________________________________________________________
20  __________3333132333_______________11___________________________________________________________________________________________________________________________
21  __________3333313233________________11__________________________________________________________________________________________________________________________
22  ___________333331323_________________11_________________________________________________________________________________________________________________________
23  ___________3333331323333______________11________________________________________________________________________________________________________________________
24  _____________33333132333_______________11_______________________________________________________________________________________________________________________
25  ______________3333313233________________11______________________________________________________________________________________________________________________
26  _______________333331323_________________11_____________________________________________________________________________________________________________________
27  ________________333331323333______________11____________________________________________________________________________________________________________________
28  __________________3333132333_______________11___________________________________________________________________________________________________________________
29  ____________________33313233_______________11___________________________________________________________________________________________________________________
30  ______________________331323________________11__________________________________________________________________________________________________________________
31  ________________________31323333_____________11_________________________________________________________________________________________________________________
32  _________________________3132333______________11________________________________________________________________________________________________________________
33  __________________________313233_______________11_______________________________________________________________________________________________________________
34  ___________________________31323________________11______________________________________________________________________________________________________________
35  ___________________________331323333_____________11_____________________________________________________________________________________________________________
36  ____________________________33132333______________11____________________________________________________________________________________________________________
37  ____________________________33313233_______________11___________________________________________________________________________________________________________
38  _____________________________3331323________________11__________________________________________________________________________________________________________
39  _____________________________333313231_______________11_________________________________________________________________________________________________________
40  ______________________________3333132_11______________11________________________________________________________________________________________________________
41  _______________________________3333132__11_____________11_______________________________________________________________________________________________________
42  ________________________________33331_2___1_____________11______________________________________________________________________________________________________
43  _________________________________33331_2___3_____________11_____________________________________________________________________________________________________
44  _________________________________3333_1_2__3______________11____________________________________________________________________________________________________
45  __________________________________333__1_2_3_______________11___________________________________________________________________________________________________
46  ___________________________________33___1_23________________11__________________________________________________________________________________________________
47  ____________________________________3____1_23333_____________11_________________________________________________________________________________________________
48  __________________________________________132333______________11________________________________________________________________________________________________
49  ___________________________________________13233_______________11_______________________________________________________________________________________________
50  ___________________________________________31323________________11______________________________________________________________________________________________
51  ___________________________________________331323333_____________11_____________________________________________________________________________________________
52  ____________________________________________33132333______________11____________________________________________________________________________________________
53  ____________________________________________33313233_______________11___________________________________________________________________________________________
54  ______________________________________________331323________________11__________________________________________________________________________________________
55  _______________________________________________331323333_____________11_________________________________________________________________________________________
56  _______________________________________________333132333______________11________________________________________________________________________________________
57  ________________________________________________33313233_______________11_______________________________________________________________________________________
58  ________________________________________________33331323________________11______________________________________________________________________________________
59  ________________________________________________333331323333_____________11_____________________________________________________________________________________
60  _________________________________________________33333132333______________11____________________________________________________________________________________
61  _________________________________________________33333313233_______________11___________________________________________________________________________________
62  _________________________________________________33333331323________________11__________________________________________________________________________________
63  __________________________________________________33333331323333_____________11_________________________________________________________________________________
64  __________________________________________________33333333132333______________11________________________________________________________________________________
65  ___________________________________________________3333333313233_______________11_______________________________________________________________________________
66  ____________________________________________________333333331323________________11______________________________________________________________________________
67  ____________________________________________________3333333331323333_____________11_____________________________________________________________________________
68  _____________________________________________________333333333132333______________11____________________________________________________________________________
69  _____________________________________________________333333333313233_______________11___________________________________________________________________________
70  _____________________________________________________333333333331323________________11__________________________________________________________________________
71  ______________________________________________________333333333331323333_____________11_________________________________________________________________________
72  _______________________________________________________33333333333132333______________11________________________________________________________________________
73  _________________________________________________________333333333313233_______________11_______________________________________________________________________
74  __________________________________________________________33333333331323________________11______________________________________________________________________
75  ___________________________________________________________333333333313231_______________11_____________________________________________________________________
76  ____________________________________________________________3333333333132_1_______________11____________________________________________________________________
77  _____________________________________________________________33333333331_2_1_______________11___________________________________________________________________
78  ______________________________________________________________33333333331_2_1_______________11__________________________________________________________________
79  _______________________________________________________________33333333__1_2_1_3_____________11_________________________________________________________________
80  _________________________________________________________________333333___1_2_13______________11________________________________________________________________
81  __________________________________________________________________3333_____1_2_3_______________11_______________________________________________________________
82  ___________________________________________________________________33_______1_23________________11______________________________________________________________
83  _____________________________________________________________________________1_23333_____________11_____________________________________________________________
84  ______________________________________________________________________________1_2333______________11____________________________________________________________
85  _______________________________________________________________________________13233______________11____________________________________________________________
86  ________________________________________________________________________________1323_______________11___________________________________________________________
87  ________________________________________________________________________________31323333____________11__________________________________________________________
88  _________________________________________________________________________________3132333_____________11_________________________________________________________
89  _________________________________________________________________________________3313233______________11________________________________________________________
90  _________________________________________________________________________________3331323_______________11_______________________________________________________
91  __________________________________________________________________________________333132331_____________11______________________________________________________
92  __________________________________________________________________________________33331323_1_____________11_____________________________________________________
93  ___________________________________________________________________________________3333132__1_____________11____________________________________________________
94  ___________________________________________________________________________________33333132__1_____________11___________________________________________________
95  ____________________________________________________________________________________333331_2_1______________11__________________________________________________
96  _____________________________________________________________________________________333331_2_1______________11_________________________________________________
97  _____________________________________________________________________________________33333_1_2_1______________11________________________________________________
98  ______________________________________________________________________________________3333__1_2_1______________11_______________________________________________
99  ______________________________________________________________________________________3333___1_2_333____________11______________________________________________
100 _______________________________________________________________________________________333____1_2333_____________11_____________________________________________
101 _______________________________________________________________________________________333_____1_233______________11____________________________________________
102 ________________________________________________________________________________________33______1323_______________11___________________________________________
103 _________________________________________________________________________________________________1323333____________11__________________________________________
104 _________________________________________________________________________________________________3132333_____________11_________________________________________
105 _________________________________________________________________________________________________3313233______________11________________________________________
106 _________________________________________________________________________________________________3331323_______________11_______________________________________
107 __________________________________________________________________________________________________3331323333____________11______________________________________
108 __________________________________________________________________________________________________3333132333_____________11_____________________________________
109 ___________________________________________________________________________________________________333313233______________11____________________________________
110 ___________________________________________________________________________________________________333331323_______________11___________________________________
111 ____________________________________________________________________________________________________333331323333____________11_____1111111111111________________
112 ____________________________________________________________________________________________________333333132333_____________11_111_____________1_______________
113 _____________________________________________________________________________________________________33333313233______________11_________________11_____________
114 ______________________________________________________________________________________________________3333331323___________________________________1____________
115 _______________________________________________________________________________________________________3333331323333________________________________1___________
116 ________________________________________________________________________________________________________333333132333_________________________________1__________
117 __________________________________________________________________________________________________________3333313233__________________________________1_________
118 ___________________________________________________________________________________________________________333331323___________________________________11_______
119 ____________________________________________________________________________________________________________333331323331_________________________________1______
120 ______________________________________________________________________________________________________________333313233_1________________________________1______
121 _______________________________________________________________________________________________________________33331323__1______________________________1_______
122 ________________________________________________________________________________________________________________3333132__1______________________________1_______
123 _________________________________________________________________________________________________________________33331_2__1_____________________________1_______
124 _________________________________________________________________________________________________________________333331_2__1_____________________________1______
125 ___________________________________________________________________________________________________________________333_1_2__1_____________________________11____
126 ________________________________________________________________________________________________________________________1_211_______________________________1_1_
127 _______________________________________________________________________________________________________________________1__1_1_________________________________1_
128 ______________________________________________________________________________________________________________________1__1__1_________________________________1_
129 _____________________________________________________________________________________________________________________1__1___1_________________________________1_
130 ____________________________________________________________________________________________________________________1__1____1_________________________________1_
131 ___________________________________________________________________________________________________________________1__1111111_________________________________1_
132 __________________________________________________________________________________________________________________1__1____________3_1_________________________1_
133 _________________________________________________________________________________________________________________1__1_____________3_11________________________1_
134 ________________________________________________________________________________________________________________1__1______________3_111_______________________1_
135 _______________________________________________________________________________________________________________1__1_______________3_1__1______________________1_
136 ______________________________________________________________________________________________________________1__1____________3____1____11____________________1_
137 _____________________________________________________________________________________________________________1__1_____________3_3_13______1___________________1_
138 ____________________________________________________________________________________________________________1__1______________3_313________1__________________1_
139 ___________________________________________________________________________________________________________1__1_______________3_133_________1111111111111111111_
140 __________________________________________________________________________________________________________1__1____________33332133______________________________
141 _________________________________________________________________________________________________________1__1_____________33321333______________________________
142 ________________________________________________________________________________________________________1__1______________3321333_______________________________
143 _______________________________________________________________________________________________________1__1_______________3213333_______________________________
144 ______________________________________________________________________________________________________1__1____________3333213333________________________________
145 _____________________________________________________________________________________________________1_11_____________3332133333________________________________
146 ____________________________________________________________________________________________________1_1_______________332133333_________________________________
147 ___________________________________________________________________________________________________1_1________________321333333_________________________________
148 __________________________________________________________________________________________________1_1_____________3333213333333_________________________________
149 _________________________________________________________________________________________________1_1______________333213333333__________________________________
150 ________________________________________________________________________________________________1_1_______________332133333333__________________________________
151 _______________________________________________________________________________________________1_1________________32133333333___________________________________
152 ______________________________________________________________________________________________1_1_____________333321333333333___________________________________
153 _____________________________________________________________________________________________1_1______________33321333333333____________________________________
154 ____________________________________________________________________________________________1_1_______________33213333333333____________________________________
155 ___________________________________________________________________________________________1_1________________3213333333333_____________________________________
156 __________________________________________________________________________________________1_1_____________33332133333___33______________________________________
157 _________________________________________________________________________________________1_1______________3332133333____________________________________________
158 ________________________________________________________________________________________1_1_______________332133333_____________________________________________
159 _______________________________________________________________________________________1_1________________32133333______________________________________________
160 ______________________________________________________________________________________1_1_____________33332133333_______________________________________________
161 _____________________________________________________________________________________1_1______________3332133333________________________________________________
162 ____________________________________________________________________________________1_1_______________3321333333________________________________________________
163 ___________________________________________________________________________________1_1________________321333333_________________________________________________
164 __________________________________________________________________________________1_1_____________333321333333__________________________________________________
165 _________________________________________________________________________________1_1________A_____333213333333__________________________________________________
166 ________________________________________________________________________________1_1_______________33213333333___________________________________________________
167 ________________________________________________________________________________________________________________________________________________________________
