    0         10        20        30        40        50        60        70        80        90        100       110       120       130       140       150       
    0123456789012345678901234567890123456789012345678901234567890123456789012345678901234567890123456789012345678901234567890123456789012345678901234567890123456789
0   ________________________________________2________________________1______________________________________________________________________________________________
1   ________________________________________2________________________1______________________________________________________________________________________________
2   ________________________________________2________________________1______________________________________________________________________________________________
3   ________________________________________2________________________1______________________________________________________________________________________________
4   ________________________________________2________________________1______________________________________________________________________________________________
5   ________________________________________2________________________1______________________________________________________________________________________________
6   ________________________________________2________________________1______________________________________________________________________________________________
7   ________________________________________2________________________1______________________________________________________________________________________________
8   ________________________________________2________________________1______________________________________________________________________________________________
9   ________________________________________2________________________1______________________________________________________________________________________________
10  ________________________________________2________________________1______________________________________________________________________________________________
11  ________________________________________2________________________1______________________________________________________________________________________________
12  ________________________________________2________________________1______________________________________________________________________________________________
13  ________________________________________2________________________1______________________________________________________________________________________________
14  ________________________________________2________________________1______________________________________________________________________________________________
15  ________________________________________2________________________1______________________________________________________________________________________________
16  ________________________________________2________________________1______________________________________________________________________________________________
17  ________________________________________2________________________1______________________________________________________________________________________________
18  ________________________________________2________________________1______________________________________________________________________________________________
19  ________________________________________2________________________1______________________________________________________________________________________________
20  ________________________________________2________________________1______________________________________________________________________________________________
21  ________________________________________2________________________1______________________________________________________________________________________________
22  ________________________________________2________________________1______________________________________________________________________________________________
23  ________________________________________2________________________1______________________________________________________________________________________________
24  ________________________________________2________________________1______________________________________________________________________________________________
25  ________________________________________2________________________1______________________________________________________________________________________________
26  ________________________________________2________________________1______________________________________________________________________________________________
27  ________________________________________2________________________1______________________________________________________________________________________________
28  ________________________________________2________________________1______________________________________________________________________________________________
29  ________________________________________2________________________1______________________________________________________________________________________________
30  ________________________________________2________________________1______________________________________________________________________________________________
31  ________________________________________2_______________________1_______________________________________________________________________________________________
32  ________________________________________2_______________________1_______________________________________________________________________________________________
33  ________________________________________2_______________________1______________________222______________________________________________________________________
34  ________________________________________2_______________________1____________________22___2222___________2222___________________________________________________
35  ________________________________________2_______________________1__________________22_________2222___2222____22_________2222____________________________________
36  ________________________________________2_______________________1_________________2_______________222__________22___2222____22__________________________________
37  ________________________________________2_______________________1_________________2______________________________222_________2__________________________________
38  ________________________________________2_______________________1_________________2__________________________________________2__________________________________
39  ________________________________________2_______________________1_________________2_________________________________________2___________________________________
40  ________________________________________2_______________________1_________________2_________________________________________2___________________________________
41  ________________________________________2______________________1__________________2_________________________________________2___________________________________
42  ________________________________________2______________________1__________________2_________________________________________211111111111111111111111111111111111
43  ________________________________________2_____________________1___________________2________________________________________2________3333333333333333333332______
44  ________________________________________2_____________________1___________________2________________________________________2________333333333333333333332_______
45  ________________________________________2____________________1____________________2________________________________________211111___33333333333333333332________
46  ________________________________________2_____________________2___________________2________________________________________2_____11_3333333333333333332_________
47  ________________________________________2____________________22___________________2_______________________________________2_______11333333333333333332__________
48  _______________________________________22____________________22___________________2_______________________________________2__111113333333333333333332___________
49  _______________________________________22__________________22_2___________________2_________________________1333333333333311133333333333333333333332____________
50  ____________________________________11122________________22___2___________________2_________________________133333333333333333333333333333333333332_____________
51  ______________________________11111133_22________________2___2_____________________2________________________13333333333333333333333333333333333332______________
52  _______________________11111113333333__22________________2___2_____________________2_________________________133333333333333333333333333333333332_______________
53  _____________________113333333333333__222________________2___2_____________________2_________________________12333333333333333333333322222222222________________
54  ___________________11333333333333333__222________________2___2_____________________2_________________________1_2333333333333333333322___________________________
55  __________________13333333333333333___22_________________2___2_____________________2_________________________1__2222233333333333322_____________________________
56  __________________13333333333333333___22_________________2___2_____________________2_________________________1_______233333333322_______________________________
57  _________________133333333333333333___22_________________2___2____________________2__________________________1________222222222_________________________________
58  _________________133333333333333311112_2________________2____2____________________2__________________________1__________________________________________________
59  _________________1333333333311111____222________________2____2____________________2__________________________1__________________________________________________
60  _________________1333333333333311111_2_________________2____2_____________________2___________________________1_________________________________________________
61  __________________1333333333333333331113333333333333331_____2_____________________2___________________________1_________________________________________________
62  __________________133333333333333333333333333333333333311___2_____________________2___________________________1_________________________________________________
63  ________________113333333333333333333333333333333333333331__2_____________________2___________________________1_________________________________________________
64  ______________11333333333333333333333333333333333333333333112_____________________2___________________________1_________________________________________________
65  ______________1333333333333333333333333333333333333333333322______________________2___________________________1_________________________________________________
66  ______________13333333333333333333333333222223333333333332_________________________2__________________________1_________________________________________________
67  ______________12222333333333333322222222_____22222222222222________________________2__________________________1_________________________________________________
68  ______________1____2222222222222___________________________________________________2__________________________1_________________________________________________
69  ______________1____________________________________________________________________2__________________________1_________________________________________________
70  ______________1____________________________________________________________________2__________________________1_________________________________________________
71  ___________________________________________________________________________________2__________________________1_________________________________________________
72  ___________________________________________________________________________________2___________________________1________________________________________________
73  ___________________________________________________________________________________2___________________________1________________________________________________
74  ___________________________________________________________________________________2___________________________1________________________________________________
75  ____________________________________________________________________________________2__________________________1________________________________________________
76  ____________________________________________________________________________________2__________________________1________________________________________________
77  ____________________________________________________________________________________2__________________________1________________________________________________
78  ____________________________________________________________________________________2__________________________1________________________________________________
79  ____________________________________________________________________________________2___________________________1_______________________________________________
80  ____________________________________________________________________________________2___________________________1_______________________________________________
81  ____________________________________________________________________________________2____________________________1______________________________________________
82  ____________________________________________________________________________________2____________________________1______________________________________________
83  ____________________________________________________________________________________2_____________________________1_____________________________________________
84  ____________________________________________________________________________________2______________________________1____________________________________________
85  _____________________________________________________________________________111111112____________________________21____________________________________________
86  ____________________________________________________________________1111111113333____2___________________________2__1___________________________________________
87  _______________________________________________________________111113333333333333____2___________________________2___1__________________________________________
88  ______________________________________________________________133333333333333333_____2__________________________2_______________________________________________
89  ___________222222222222222222222222222222222222222222222222__1333333333333333333_____2__________________________2_______________________________________________
90  ___________2______________________________________________2_13333333333333333333_____2_________________________2________________________________________________
91  ___________2______________________________________________2133333333333333333333_____2________________________2_________________________________________________
92  ___________2______________________________________________213333333333333333333_______2_____________________22__________________________________________________
93  ___________2______________________________________________133333333333333333333_______2____________________2____________________________________________________
94  ___________2________________________________3_____________133333333333333333333_1111112___________________2_____________________________________________________
95  ___________2________________________________3333333333333333333333333333311111111111__2___________________2_____________________________________________________
96  ___________2________________________________133333333333333333333333333333333333333312_____________________2____________________________________________________
97  ___________2________________________________133333333333333333333333333333333333333312_____________________2____________________________________________________
98  ___________2________________________________133333333333333333333333333333333333333331_____________________2____________________________________________________
99  ___________2________________________________133333333333333333333333333333333333333331_____________________2____________________________________________________
100 ___________2________________________________133333333333333332222333333333333333222222_____________________2____________________________________________________
101 ___________2________________________________13333333333222222____222222222222222_____2_____________________2____________________________________________________
102 ___________2_________________________________1222222222______________________________2_____________________2____________________________________________________
103 ____________2________________________________12_____________________________________2______________________2____________________________________________________
104 ____________2________________________________12_____________________________________2______________________2____________________________________________________
105 _____________2_______________________________12_____________________________________2______________________2____________________________________________________
106 ______________2______________________________12_____________________________________2______________________2____________________________________________________
107 ______________2______________________________1_2___________________________________2______________________2_____________________________________________________
108 _______________2_____________________________1_2___________________________________2______________________2_____________________________________________________
109 ________________2____________________________1__2__________________________________2_____________________2______________________________________________________
110 ________________2____________________________1__2__________________________________2____________________2_______________________________________________________
111 _________________2222222_____________________1___2________________________________2_____________________2_______________________________________________________
112 _______________________2_____________________1___2________________________________2____________________2________________________________________________________
113 ________________________2_____________________1___2_______________________________2___________________2_________________________________________________________
114 ________________________2_____________________1___2_______________________________2___________________2_________________________________________________________
115 ________________________2_____________________1____2_____________________________2___________________2__________________________________________________________
116 _________________________2____________________1____2_____________________________2___________________2__________________________________________________________
117 _________________________2____________________1____2____________________________2___________________2___________________________________________________________
118 _________________________2____________________1_____2___________________________2___________________2___________________________________________________________
119 __________________________2___________________1_____2__________________________2___________________2____________________________________________________________
120 __________________________2____________________1_____2_________________________2__________________2_____________________________________________________________
121 __________________________2____________________1_____2________________________2___________________2_____________________________________________________________
122 ___________________________2___________________1______2_______________________2__________________2______________________________________________________________
123 ___________________________2___________________1______2______________________2___________________2______________________________________________________________
124 ___________________________2___________________1_______2_____________________2__________________2_______________________________________________________________
125 ____________________________2__________________1_______2222222222222222222222___________________2_______________________________________________________________
126 ____________________________2__________________1________2_______________________________________2_______________________________________________________________
127 ____________________________2___________________1_______2_______________________________________2_______________________________________________________________
128 ____________________________2___________________1_______2_______________________________________2_______________________________________________________________
129 _____________________________2__________________1_______2______________________________________2________________________________________________________________
130 _____________________________2__________________1_______2______________________________________2________________________________________________________________
131 _____________________________2__________________1_______2______________________________________2________________________________________________________________
132 _____________________________2__________________1_______2______________________________________2________________________________________________________________
133 ______________________________2__________________1______2_____________________________________2_________________________________________________________________
134 ______________________________2__________________1______2_____________________________________2_________________________________________________________________
135 ______________________________22_________________1______2____________________________________2__________________________________________________________________
136 ______________________________22_________________1_______2__________________________________2__1__________________________________________1111111111111111111___
137 ______________________________2_2_________________1______2__________________________________211_1____________________________1111111111111333_______________1___
138 _____________________________2__2_________________1_______2_________________________________2___31___________________________1________3333333_______________1___
139 _____________________________12_2_________________1_______2_________________________________2___331__________________________1________3333333_______________1___
140 ___________________________1132_2_________________1________2________________________________2___33311________________________1________3333333_______________1___
141 __________________________13332__2_________________1_______2________________________________2__33333311______________________1________333333________________1___
142 _________________________1333332_2_________________1________2_______________________________2__3333333311111111111___________1_________33333________________1___
143 _______________________113333332_2_________________1________2_______________________________2__3333333333________1___________111111111111133________________1___
144 ____________________11133333333_22_________________1________2_______________________________2___333333333________1_______________________1111_______________1___
145 ___________________133333333333__2__________________1_______2_______________________________2___33333333_________1____________________111333________________1___
146 ___________________13333333333___22_________________1_______2_______________________________2____333_333_________1__________________11333333________________1___
147 __________________133333333333____2_________________1_______2_______________________________2____333__33_________1_________________1_333333_________________1___
148 _________________1333333333333____2_________________1________2______________________________2____333___3_________1___________11111133333333_________________1___
149 _________________1333333333333____2__________________1_______2______________________________21__3333___3_________1___________1333333333333__________________1___
150 ___________1111113333333333333___22__________________1_______2______________________________2_11113______________1_________11333333333333___________________1___
151 __________13333333333333333333__12___________________1_______2______________________________2_____11_____________1_______11_333333333333____________________1___
152 __________13333333333333333333_122___________________1_______2______________________________2_______1_____________1___111_3333333333333_____11111111111111111___
153 _________13333333333333333333_1_2_____________________1______2______________________________2_______1_____________1___13333333333333333___11____________________
154 ________1333333333333333333331__2_____________________1______2______________________________2________1____________1__1_333333333333333__11______________________
155 ________133333333333333333331__2______________________1______2_______________________________1111111111___________1__1_33333333333333311________________________
156 _______13333333333333333333331_2______________________1_____2_______________________________1333__________________1__1_33333333333333331________________________
157 _______133333333333333333333312________________________1____2_______________________________133___________________1__13333333333333333331_______________________
158 ______1333333333333333333333332________________________1____2_______________1333333333333333333___________________1__133333333333333333331_____1111111111_______
159 ______1333333333333333333333331________________________1____2_______________1333333333333333333___________________1__1333333333333333333331111133333333331111___
160 ______133333333333333333333333313333333333333333333333331___2_______________1333333333333333333___________________1__1333333333333333333333333333333333333333111
161 _______13333333333333333333333333333333333333333333333331___2________________133333333333333333_____111111111111111__1333333333333333333333333333333333333333333
162 _______133333333333333333333333333333333333333333333333331_2_________________13333333333333333__1111_________________1333333333333333333333333333333333333333333
163 _______133333333333333333333333333333333333333333333333331_2_________________1333333333333333311_____________________1333333333333333333333333333333333333333333
164 _______13333333333333333333333333333333333333333333333333312_________________122333333333333331______________________1333333333333333333333333333333333333333333
165 ________133333333333333333333333333333333333333333333333331__________________1__22222222222221_______________________1333333333333333333333333333333333333333333
166 _______22222222222222222222222222222222222222222222222222221_________________1_______________1_______________________2222222222222222222222222222222222222222222
167 ________1333333333333333333333333333333333333333333333333331_________________1_______________1_______________________1333333333333333333333333333333333333333333
