    0         10        20        30        40        50        60        70        80        90        100       110       120       130       140       150
    0123456789012345678901234567890123456789012345678901234567890123456789012345678901234567890123456789012345678901234567890123456789012345678901234567890123456789
0   ________________________________________________________________________________________________________________________________________________________________
1   ________________________________________________________________________________________________________________________________________________________________
2   ________________________________________________________________________________________________________________________________________________________________
3   ________________________________________________________________________________________________________________________________________________________________
4   ________________________________________________________________________________________________________________________________________________________________
5   ________________________________________________________________________________________________________________________________________________________________
6   ________________________________________________________________________________________________________________________________________________________________
7   ________________________________________________________________________________________________________________________________________________________________
8   ________________________________________________________________________________________________________________________________________________________________
9   ________________________________________________________________________________________________________________________________________________________________
10  1111111111111111111111111111111111111111111111111111111111111111111111111111111111111111111111111111111111111111111111111111111111111111111111111111111_________
11  1_____________________________________________________________________________________________________________________________________________________1_________
12  1_____________________________________________________________________________________________________________________________________________________1_________
13  1_____________________________________________________________________________________________________________________________________________________1_________
14  1_____________________________________________________________________________________________________________________________________________________1_________
15  1_____________________________________________________________________________________________________________________________________________________1_________
16  1_____________________________________________________________________________________________________________________________________________________1_________
17  1_____________________________________________________________________________________________________________________________________________________1_________
18  1_____________________________________________________________________________________________________________________________________________________1_________
19  1_____________________________________________________________________________________________________________________________________________________1_________
20  1_____________________________________________________________________________________________________________________________________________________1_________
21  1_____________________________________________________________________________________________________________________________________________________1_________
22  1_____________________________________________________________________________________________________________________________________________________1_________
23  1_____________________________________________________________________________________________________________________________________________________1_________
24  1_____________________________________________________________________________________________________________________________________________________1_________
25  1_____________________________________________________________________________________________________________________________________________________1_________
26  1_____________________________________________________________________________________________________________________________________________________1_________
27  1_____________________________________________________________________________________________________________________________________________________1_________
28  1_____________________________________________________________________________________________________________________________________________________1_________
29  1_____________________________________________________________________________________________________________________________________________________1_________
30  1_____________________________________________________________________________________________________________________________________________________1_________
31  1_____________________________________________________________________________________________________________________________________________________1_________
32  1_____________________________________________________________________________________________________________________________________________________1_________
33  1_____________________________________________________________________________________________________________________________________________________1_________
34  1_____________________________________________________________________________________________________________________________________________________1_________
35  1_____________________________________________________________________________________________________________________________________________________1_________
36  1_____________________________________________________________________________________________________________________________________________________1_________
37  1_____________________________________________________________________________________________________________________________________________________1_________
38  1_____________________________________________________________________________________________________________________________________________________1_________
39  1_____________________________________________________________________________________________________________________________________________________1_________
40  1_____________________________________________________________________________________________________________________________________________________1_________
41  1111111111111111111111111111111111111111111111111111111111111111111111111111111111111111111111111111111111111111111111111111111111111111111111111111111111111111
42  ________________________________________________________________________________________________________________________________________________________________
43  ________________________________________________________________________________________________________________________________________________________________
44  ________________________________________________________________________________________________________________________________________________________________
45  ________________________________________________________________________________________________________________________________________________________________
46  ________________________________________________________________________________________________________________________________________________________________
47  ________________________________________________________________________________________________________________________________________________________________
48  33333___________________________________________________________________________________________________________________________________________________________
49  3333333333333___________________________________________________________________________________________________________________________________________________
50  33333333333333333__________________________________________________________________________________________________________________________________3333333333333
51  33333333333333333______________________________________________________________________________________________________________________________33333333333333333
52  333333333333333333___________________________________________________________________________________________________________________________3333333333333333333
53  33333333333333333__________________________________________________________________________________________________________________________333333333333333333333
54  3333333333333333_________________________________________________________________________________________________________________________33333333333333333333333
55  3333333333333333_______________________________________________________________________________________________________________________3333333333333333333333333
56  333333333333333________________________________________________________________________________________________________________________33_3333333333333333333333
57  3333333333333_________________________________________________________________________________________________________________________333_3333333333333333333333
58  333333333_____________________________________________________________________________________________________________________________33_33333333333333333333333
59  3333_________________________________________________________________________________________________________________________________333_33333333333333333333333
60  _____________________________________________________________________________________________________________________________________33_333333333333333333333333
61  ____________________________________________________________________________________________________________________________________333_333333333333333333333333
62  ____________________________________________________________________________________________________________________________________33_3333333333333333333333333
63  ___________________________________________________________________________________________________________________________________333_3333333333333333333333333
64  ___________________________________________________________________________________________________________________________________333_3333333333333333333333333
65  __________________________________________________________________________________________________________________________________333_33333333333333333333333333
66  __________________________________________________________________________________________________________________________________333_33333333333333333333333333
67  _________________________________________________________________________________________________________________________________333_333333333333333333333333333
68  _________________________________________________________________________________________________________________________________333_333333333333333333333333333
69  ______________________________________________________________________________111111111__________________________________________333_333333333333333333333333333
70  _________________________________________________________________________11111_________1111______________________________________33_3333333333333333333333333333
71  ________________________________________________________________________11________________1_____________________________________333_3333333333333333333333333333
72  __________________________________________________________________________11_____________1______________________________________33_33333333333333333333333333333
73  ____________________________________________________________________________11___________1______________________________________33_33333333333333333333333333333
74  ______________________________________________________________________________11________1_______________________________________3_333333333333333333333333333333
75  ________________________________________________________________________________11111111_______________________________________33_333333333333333333333333333333
76  _______________________________________________________________________________________________________________________________33_333333333333333333333333333333
77  _______________________________________________________________________________________________________________________________33_333333333333333333333333333333
78  _______________________________________________________________________________________________________________________________33_333333333333333333333333333333
79  ______________________________________________________________________________________________________________________________33_3333333333333333333333333333333
80  ________________________________________________X..............X______________________________________________________________33_3333333333333333333333333333333
81  ________________________________111111__________.______________.____if overheard the mice the area____________________________33_3333333333333333333333333333333
82  ______________________________11______1_________.____X....X____.____for finding the chest is bigger___________________________33_3333333333333333333333333333333
83  _____________________________111_____111________.____.____.____._____________________________________________________________333_3333333333333333333333333333333
84  ________________________________11111___________.____.____.____._____________________________________________________________333_3333333333333333333333333333333
85  ________________________________________________.____X....X____._____________________________________________________________33_33333333333333333333333333333333
86  ________________________________________________.______________.____________________________________________________________333_33333333333333333333333333333333
87  ________________________________________________.______________.____________________________________________________________333_33333333333333333333333333333333
88  ________________________________________________X..............X___________________________________________________________3333_33333333333333333333333333333333
89  ___________________________________________________________________________________________________________________________3333_33333333333333333333333333333333
90  ___________________________________________________________________________________________________________________________3333_33333333333333333333333333333333
91  ___________________________________________________________________________________________________________________________3333_33333333333333333333333333333333
92  ___________________________________________________________________________________________________________________________333_333333333333333333333333333333333
93  ___________________________________________________________________________________________________________________________333_333333333333333333333333333333333
94  __________________1111_____________________________________________________________________________________________________333_333333333333333333333333333333333
95  ________________11____1111_1_______________________________________________________________________________________________333_333333333333333333333333333333333
96  ______________11_________11________________________________________________________________________________________________333_333333333333333333333333333333333
97  ________________111____11__________________________________________________________________________________________________333_333333333333333333333333333333333
98  ___________________1111____________________________________________________________________________________________________33_3333333333333333333333333333333333
99  __________________________________________________________________________________________________________________________333_3333333333333333333333333333333333
100 __________________________________________________________________________________________________________________________333_3333333333333333333333333333333333
101 __________________________________________________________________________________________________________________________333_3333333333333333333333333333333333
102 _________________________________________________________________________________________________________________________333_33333333333333333333333333333333333
103 _________________________________________________________________________________________________________________________33_333333333333333333333333333333333333
104 ________________________________________________________________________________________________________________________33_3333333333333333333333333333333333333
105 _______________________________________________________________________________________________________________________33_33333333333333333333333333333333333333
106 ______________________________________________________________________________________________________________________33_333333333333333333333333333333333333333
107 ______________________________________________________________________________________________________________________3_3333333333333333333333333333333333333333
108 _____________________________________________________________________________________________________________________3_33333333333333333333333333333333333333333
109 ___________________________________________________________________________________________________________________33_333333333333333333333333333333333333333333
110 _________________________________________________________________________________________________________________333_3333333333333333333333333333333333333333333
111 ______________________________________________________________________________________________________________33333_33333333333333333333333333333333333333333333
112 ____________________________________________________________________________________________________________333333_333333333333333333333333333333333333333333333
113 ___________________________________________________________________________________________________________333333_3333333333333333333333333333333333333333333333
114 __________________________________________________________________________________________________________333333_33333333333333333333333333333333333333333333333
115 _________________________________________________________________________________________________________333333_333333333333333333333333333333333333333333333333
116 ________________________________________________________________________________________________________333333_3333333333333333333333333333333333333333333333333
117 ______________________________________________________________________________________________________3333333_33333333333333333333333333333333333333333333333333
118 _____________________________________________________________________________________________________3333333_333333333333333333333333333333333333333333333333333
119 ____________________________________________________________________________________________________3333333_3333333333333333333333333333333333333333333333333333
120 ___________________________________________________________________________________________________3333333_33333333333333333333333333333333333333333333333333333
121 ___________________________________________________________________________________________________333333_333333333333333333333333333333333333333333333333333333
122 __________________________________________________________________________________________________333333_3333333333333333333333333333333333333333333333333333333
123 __________________________________________________________________________________________________33333_33333333333333333333333333333333333333333333333333333333
124 __________________________________________________________________________________________________3333_333333333333333333333333333333333333333333333333333333333
125 _________________________________________________________________________________________________3333_3333333333333333333333333333333333333333333333333333333333
126 _________________________________________________________________________________________________333_33333333333333333333333333333333333333333333333333333333333
127 _________________________________________________________________________________________________33_333333333333333333333333333333333333333333333333333333333333
128 ________________________________________________________________________________________________333_333333333333333333333333333333333333333333333333333333333333
129 _______________________________________________________________________________________________333_3333333333333333333333333333333333333333333333333333333333333
130 _______________________________________________________________________________________________33_33333333333333333333333333333333333333333333333333333333333333
131 ______________________________________________________________________________________________33_333333333333333333333333333333333333333333333333333333333333333
132 _____________________________________________________________________________________________33_3333333333333333333333333333333333333333333333333333333333333333
133 ____________________________________________________________________________________________33_33333333333333333333333333333333333333333333333333333333333333333
134 __________________________________________________________________________________________33__333333333333333333333333333333333333333333333333333333333333333333
135 ________________________________________________________________________________________333_33333333333333333333333333333333333333333333333333333333333333333333
136 _______________________________________________________________________________________33__333333333333333333333333333333333333333333333333333333333333333333333
137 _____________________________________________________________________________________33__33333333333333333333333333333333333333333333333333333333333333333333333
138 ___________________________________________________________________________________333_3333333333333333333333333333333333333333333333333333333333333333333333333
139 __________________________________________________________________________________33__33333333333333333333333333333333333333333333333333333333333333333333333333
140 ________________________________________________________________________________333_3333333333333333333333333333333333333333333333333333333333333333333333333333
141 _______________________________________________________________________________33__33333333333333333333333333333333333333333333333333333333333333333333333333333
142 _____________________________________________________________________________333_3333333333333333333333333333333333333333333333333333333333333333333333333333333
143 ___________________________________________________________________________333__33333333333333333333333333333333333333333333333333333333333333333333333333333333
144 __________________________________________________________________________33__3333333333333333333333333333333333333333333333333333333333333333333333333333333333
145 ________________________________________________________________________333_333333333333333333333333333333333333333333333333333333333333333333333333333333333333
146 ______________________________________________________________________333__3333333333333333333333333333333333333333333333333333333333333333333333333333333333333
147 ______________________________________________________________33333333___333333333333333333333333333333333333333333333333333333333333333333333333333333333333333
148 _____________________________________________33333333______33333______333333333333333333333333333333333333333333333333333333333333333333333333333333333333333333
149 _________________________________________333333333333333333_____333333333333333333333333333333333333333333333333333333333333333333333333333333333333333333333333
150 _____________________________________3333333333333333______33333333333333333333333333333333333333333333333333333333333333333333333333333333333333333333333333333
151 ________________________________33333333333333_______33333333333333333333333333333333333333333333333333333333333333333333333333333333333333333333333333333333333
152 ____________________________33333333333_______333333333333333333333333333333333333333333333333333333333333333333333333333333333333333333333333333333333333333333
153 ____________________333333333333_______3333333333333333333333333333333333333333333333333333333333333333333333333333333333333333333333333333333333333333333333333
154 333_______3333__________________33333333333333333333333333333333333333333333333333333333333333333333333333333333333333333333333333333333333333333333333333333333
155 ______________33333333333333333333333333333333333333333333333333333333333333333333333333333333333333333333333333333333333333333333333333333333333333333333333333
156 3333333333333333333333333333333333333333333333333333333333333333333333333333333333333333333333333333333333333333333333333333333333333333333333333333333333333333
157 3333333333333333333333333333333333333333333333333333333333333333333333333333333333333333333333333333333333333333333333333333333333333333333333333333333333333333
158 3333333333333333333333333333333333333333333333333333333333333333333333333333333333333333333333333333333333333333333333333333333333333333333333333333333333333333
159 3333333333333333333333333333333333333333333333333333333333333333333333333333333333333333333333333333333333333333333333333333333333333333333333333333333333333333
160 3333333333333333333333333333333333333333333333333333333333333333333333333333333333333333333333333333333333333333333333333333333333333333333333333333333333333333
161 3333333333333333333333333333333333333333333333333333333333333333333333333333333333333333333333333333333333333333333333333333333333333333333333333333333333333333
162 3333333333333333333333333333333333333333333333333333333333333333333333333333333333333333333333333333333333333333333333333333333333333333333333333333333333333333
163 3333333333333333333333333333333333333333333333333333333333333333333333333333333333333333333333333333333333333333333333333333333333333333333333333333333333333333
164 3333333333333333333333333333333333333333333333333333333333333333333333333333333333333333333333333333333333333333333333333333333333333333333333333333333333333333
165 3333333333333333333333333333333333333333333333333333333333333333333333333333333333333333333333333333333333333333333333333333333333333333333333333333333333333333
166 3333333333333333333333333333333333333333333333333333333333333333333333333333333333333333333333333333333333333333333333333333333333333333333333333333333333333333
167 3333333333333333333333333333333333333333333333333333333333333333333333333333333333333333333333333333333333333333333333333333333333333333333333333333333333333333
