    0         10        20        30        40        50        60        70        80        90        100       110       120       130       140       150       
    0123456789012345678901234567890123456789012345678901234567890123456789012345678901234567890123456789012345678901234567890123456789012345678901234567890123456789
0   ________________________________________________________________________________________________________________________________________________________________
1   ________________________________________________________________________________________________________________________________________________________________
2   ________________________________________________________________________________________________________________________________________________________________
3   ________________________________________________________________________________________________________________________________________________________________
4   ________________________________________________________________________________________________________________________________________________________________
5   ________________________________________________________________________________________________________________________________________________________________
6   ________________________________________________________________________________________________________________________________________________________________
7   ________________________________________________________________________________________________________________________________________________________________
8   ________________________________________________________________________________________________________________________________________________________________
9   ________________________________________________________________________________________________________________________________________________________________
10  ________________________________________________________________________________________________________________________________________________________________
11  ________________________________________________________________________________________________________________________________________________________________
12  ________________________________________________________________________________________________________________________________________________________________
13  ________________________________________________________________________________________________________________________________________________________________
14  ________________________________________________________________________________________________________________________________________________________________
15  ________________________________________________________________________________________________________________________________________________________________
16  ________________________________________________________________________________________________________________________________________________________________
17  ________________________________________________________________________________________________________________________________________________________________
18  ________________________________________________________________________________________________________________________________________________________________
19  ________________________________________________________________________________________________________________________________________________________________
20  ________________________________________________________________________________________________________________________________________________________________
21  ________________________________________________________________________________________________________________________________________________________________
22  ________________________________________________________________________________________________________________________________________________________________
23  ________________________________________________________________________________________________________________________________________________________________
24  ________________________________________________________________________________________________________________________________________________________________
25  ________________________________________________________________________________________________________________________________________________________________
26  ________________________________________________________________________________________________________________________________________________________________
27  ________________________________________________________________________________________________________________________________________________________________
28  ________________________________________________________________________________________________________________________________________________________________
29  _________________________________________________________1______________________________________________________________________________________________________
30  _________________________________________________________1______________________________________________________________________________________________________
31  _________________________________________________________1______________________________________________________________________________________________________
32  _________________________________________________________1______________________________________________________________________________________________________
33  _________________________________________________________1______________________________________________________________________________________________________
34  _________________________________________________________1______________________________________________________________________________________________________
35  _________________________________________________________1______________________________________________________________________________________________________
36  _________________________________________________________1______________________________________________________________________________________________________
37  _________________________________________________________1______________________________________________________________________________________________________
38  _________________________________________________________1______________________________________________________________________________________________________
39  _________________________________________________________1______________________________________________________________________________________________________
40  _________________________________________________________1______________________________________________________________________________________________________
41  _________________________________________________________1______________________________________________________________________________________________________
42  _________________________________________________________1______________________________________________________________________________________________________
43  _________________________________________________________1______________________________________________________________________________________________________
44  _________________________________________________________1______________________________________________________________________________________________________
45  _________________________________________________________1______________________________________________________________________________________________________
46  _________________________________________________________1______________________________________________________________________________________________________
47  _________________________________________________________1______________________________________________________________________________________________________
48  _________________________________________________________13333__________________________________________________________________________________________________
49  _________________________________________________________1_3333333______________________________________________________________________________________________
50  _______________________________________________________11___3333333_____________________________________________________________________________________________
51  _____________________________________________________11_______3333333___________________________________________________________________________________________
52  ___________________________________________________11__________3333333__________________________________________________________________________________________
53  ______________________________________1111111111111____________33333333_________________________________________________________________________________________
54  ____________________________________11__________________________333333333_______________________________________________________________________________________
55  __________________________________11____________________________33333333333_____________________________________________________________________________________
56  ________________________________11_______________________________33333333333____________________________________________________________________________________
57  ________________________________1________________________________333333333333___________________________________________________________________________________
58  ________________________________1________________________________3333333333333__________________________________________________________________________________
59  _______________________________1_________________________________3333333333333__________________________________________________________________________________
60  _______________________________1_________________________________3333333333333__________________________________________________________________________________
61  _______________________________1_________________________________33333333333333_________________________________________________________________________________
62  _______________________________1_______________________________33333333333333___________________________________________________________________________________
63  _______________________________1_____________________________33333333333333_____________________________________________________________________________________
64  ______________________________1______________________________3333333333333______________________________________________________________________________________
65  ______________________________1_____________________________333333333333________________________________________________________________________________________
66  ______________________________1_____________________________3333333333__________________________________________________________________________________________
67  _____________________________1_____________________________333333333____________________________________________________________________________________________
68  _____________________________1_____________________________3333333______________________________________________________________________________________________
69  _____________________________1____________________________3333333_______________________________________________________________________________________________
70  _____________________________1__________________________333333333_______________________________________________________________________________________________
71  _____________________________1_________________________333333333________________________________________________________________________________________________
72  _____________________________1________________________3333333333________________________________________________________________________________________________
73  _____________________________1______________________33333333333_________________________________________________________________________________________________
74  _____________________________1_____________________333333333333_________________________________________________________________________________________________
75  _____________________________1____________________3333333333333_________________________________________________________________________________________________
76  _____________________________1__________________3333333333333333________________________________________________________________________________________________
77  _____________________________1_________________33333333333333333________________________________________________________________________________________________
78  _____________________________1__________________33333333333333333_______________________________________________________________________________________________
79  _____________________________1__________________333333333333333333_______________________________________11111111_______________________________________________
80  _____________________________1___________________3333333333333333333____________________________111111111________11_____________________________________________
81  _____________________________1___________________33333333333333333333__________________________1___________________11___________________________________________
82  ______________________________1____________________33333333333333333333______________________11______________________11_________________________________________
83  ______________________________1_____________________333333333333333333333___________________1__________________________1________________________________________
84  ______________________________1_______________________33333333333333333333_________________11________________________11_________________________________________
85  _______________________________1________________________3333333333333333333__________________1111___________111111111___________________________________________
86  _______________________________1_________________________33333333333333333333____________________11111111111____________________________________________________
87  _______________________________1___________________________333333333333333333333________________________________________________________________________________
88  _______________________________1_____________________________3333333333333333333333_____________________________________________________________________________
89  ________________________________1________________________________33333333333333333333___________________________________________________________________________
90  ________________________________1____________________________________333333333333333333_________________________________________________________________________
91  ________________________________1________________________________________3333333333333333_______________________________________________________________________
92  _________________________________1_________________________________________33333333333333333____________________________________________________________________
93  _________________________________1__________________________________________333333333333333333__________________________________________________________________
94  _________________________________1___________________________________________33333333333333333333_______________________________________________________________
95  __________________________________1_____________________________________________3333333333333333333_____________________________________________________________
96  __________________________________1_______________________________________________3333333333333333333___________________________________________________________
97  __________________________________1__________________________________________________333333333333333333_________________________________________________________
98  ___________________________________1___________________________________________________333333333333333333_______________________________________________________
99  ___________________________________1____________________________________________________3333333333333333333_____________________________________________________
100 ___________________________________1______________________________________________________3333333333333333333___________________________________________________
101 ____________________________________1_______________________________________________________3333333333333333333_________________________________________________
102 ____________________________________1_________________________________________________________33333333333333333_________________________________________________
103 ____________________________________1_____________________________________________________________33333333333___________________________________________________
104 ____________________________________1________________________________________________________________333333333__________________________________________________
105 _____________________________________1_________________________________________________________________3333333__________________________________________________
106 _____________________________________1__________________________________________________________________33333333________________________________________________
107 _____________________________________1____________________________________________________________________333333333_____________________________________________
108 ______________________________________1____________________________________________________________________33333333333__________________________________________
109 ______________________________________1______________________________________________________________________33333333333333_____________________________________
110 ______________________________________1________________________________________________________________________3333333333333333_________________________________
111 _______________________________________1_________________________________________________________________________33333333333333_________________________________
112 _______________________________________11________________________________________________________________________33333333333333_________________________________
113 _________________________________________1111____________________________________________________________________333333333333333___________33_____________333333
114 _____________________________________________111__________________________________________________________________33333333333333___________33________33333333333
115 ________________________________________________1111______________________________________________________________33333333333333___________33________33333333333
116 ____________________________________________________111___________________________________________________________33333333333333___________33________33333333333
117 _______________________________________________________1111____________________________1111_______________________33333333333333___________33________33333333333
118 ___________________________________________________________111____________________11111____111___________________333333333333333___________33________33333333333
119 ______________________________________________________________1111_____________111____________111________________333333333333333___________33________33333333333
120 __________________________________________________________________11__________11_________________11_____________3333333333333333___________33________33333333333
121 ___________________________________________________________________1____________1111___________11_______________3333333333333333___________3_________33333333333
122 __________________________________________________________________1_________________111111___11________________33333333333333333___________3_________33333333333
123 __________________________________________________________________1_______________________111___________________3333333333333333___________3__________3333333333
124 _________________________________________________________________1________________________________________________33333333333333___________3__________3333333333
125 _________________________________________________________________1__________________________________________________333333333333___________3__________3333333333
126 ________________________________________________________________1______________________________________________________333333333___________3__________3333333333
127 _______________________________________________________________1___________________________________________________________333________________________3333333333
128 _______________________________________________________________1______________________________________________________________________________________3333333333
129 _____________________________________________________________11_______________________________________________________________________________________3333333333
130 ___________________________________________________________11_____________________________________________________________________________________________333333
131 _________________________________________________________11_____________________________________________________________________________________________________
132 _______________________________________________________11_______________________________________________________________________________________________________
133 __________________________________________1111111111111_________________________________________________________________________________________________________
134 ________1111111111111111111111111111111111______________________________________________________________________________________________________________________
135 ______11________________________________________________________________________________________________________________________________________________________
136 ____11__________________________________________________________________________________________________________________________________________________________
137 __11____________________________________________________________________________________________________________________________________________________________
138 11______________________________________________________________________________________________________________________________________________________________
139 ________________________________________________________________________________________________________________________________________________________________
140 ________________________________________________________________________________________________________________________________________________________________
141 ____________________________________________111111______________________________________________________________________________________________________________
142 __________________________________1111111111______11____________________________________________________________________________________________________________
143 ____________________________111111__________________11__________________________________________________________________________________________________________
144 _____________________________11_______________________1_________________________________________________________________________________________________________
145 _______________________________1_____________________1__________________________________________________________________________________________________________
146 ________________________________11__________________1___________________________________________________________________________________________________________
147 __________________________________11__11111111111111____________________________________________________________________________________________________________
148 ____________________________________11__________________________________________________________________________________________________________________________
149 ________________________________________________________________________________________________________________________________________________________________
150 ________________________________________________________________________________________________________________________________________________________________
151 ________________11______________________________________________________________________________________________________________________________________________
152 _____________111__11____________________________________________________________________________________________________________________________________________
153 __________111_______11__________________________________________________________________________________________________________________________________________
154 ________11____________1_________________________________________________________________________________________________________________________________________
155 _______1_______________11_______________________________________________________________________________________________________________________________________
156 ________11_______________1______________________________________________________________________________________________________________________________________
157 __________11___________11_______________________________________________________________________________________________________________________________________
158 ____________1________11_________________________________________________________________________________________________________________________________________
159 _____________11_____1___________________________________________________________________________________________________________________________________________
160 _______________11_11____________________________________________________________________________________________________________________________________________
161 _________________1______________________________________________________________________________________________________________________________________________
162 ________________________________________________________________________________________________________________________________________________________________
163 ________________________________________________________________________________________________________________________________________________________________
164 ________________________________________________________________________________________________________________________________________________________________
165 ________________________________________________________________________________________________________________________________________________________________
166 ________________________________________________________________________________________________________________________________________________________________
167 ________________________________________________________________________________________________________________________________________________________________
