    0         10        20        30        40        50        60        70        80        90        100       110       120       130       140       150
    0123456789012345678901234567890123456789012345678901234567890123456789012345678901234567890123456789012345678901234567890123456789012345678901234567890123456789
0   ________________________________________________________________________________________________________________________________________________________________
1   ________________________________________________________________________________________________________________________________________________________________
2   ________________________________________________________________________________________________________________________________________________________________
3   ________________________________________________________________________________________________________________________________________________________________
4   ________________________________________________________________________________________________________________________________________________________________
5   ________________________________________________________________________________________________________________________________________________________________
6   ________________________________________________________________________________________________________________________________________________________________
7   ________________________________________________________________________________________________________________________________________________________________
8   ________________________________________________________________________________________________________________________________________________________________
9   ________________________________________________________________________________________________________________________________________________________________
10  ________________________________________________________________________________________________________________________________________________________________
11  ________________________________________________________________________________________________________________________________________________________________
12  ________________________________________________________________________________________________________________________________________________________________
13  ________________________________________________________________________________________________________________________________________________________________
14  ________________________________________________________________________________________________________________________________________________________________
15  _______________________________________________________________________________________________________________________________________________________________1
16  ______________________________________________________________________________________________________________________________________________________________1_
17  _____________________________________________________________________________________________________________________________________________________________1__
18  _____________________________________________________________________________________________________________________________________________________________1__
19  ____________________________________________________________________________________________________________________________________________________________1___
20  ___________________________________________________________________________________________________________________________________________________________1____
21  __________________________________________________________________________________________________________________________________________________________1_____
22  _________________________________________________________________________________________________________________________________________________________1______
23  ________________________________________________________________________________________________________________________________________________________1_______
24  ________________________________________________________________________________________________________________________________________________________1_______
25  _______________________________________________________________________________________________________________________________________________________1________
26  ______________________________________________________________________________________________________________________________________________________1_________
27  _____________________________________________________________________________________________________________________________________________________1__________
28  ____________________________________________________________________________________________________________________________________________________1___________
29  ___________________________________________________________________________________________________________________________________________________1____________
30  ___________________________________________________________________________________________________________________________________________________1____________
31  __________________________________________________________________________________________________________________________________________________1____________1
32  _________________________________________________________________________________________________________________________________________________1____________1_
33  ________________________________________________________________________________________________________________________________________________1____________1__
34  _______________________________________________________________________________________________________________________________________________1_____________1__
35  _______________________________________________________________________________________________________________________________________________1____________1___
36  ______________________________________________________________________________________________________________________________________________1____________1____
37  _____________________________________________________________________________________________________________________________________________1____________1_____
38  ____________________________________________________________________________________________________________________________________________1____________1______
39  ___________________________________________________________________________________________________________________________________________1_____________1______
40  __________________________________________________________________________________________________________________________________________1_____________1_______
41  __________________________________________________________________________________________________________________________________________1____________1________
42  _________________________________________________________________________________________________________________________________________1____________1_________
43  ________________________________________________________________________________________________________________________________________1_____________1_________
44  _______________________________________________________________________________________________________________________________________1_____________1__________
45  ______________________________________________________________________________________________________________________________________1_____________1___________
46  ___________________________________________________________________________________________________________tower_____________________1_____________1____________
47  ___________________________________________________________________________________________________________(120, 50, 139, 52)________1____________1_____________
48  ____________________________________________________________________________________________________________________________________1_____________1_____________
49  ___________________________________________________________________________________________________________________________________1____________________________
50  ________________________________________________________________________________________________________________________XXXXXXXXXX1XXXXXXXXX____1_______________
51  ________________________________________________________________________________________________________________________X________1_________X___1________________
52  ________________________________________________________________________________________________________________________XXXXXXXXX1XXXXXXXXXX__1_________________
53  ________________________________________________________________________________________________________________________________1N____________1_________________ N = 129,53
54  _______________________________________________________________________________________________________________________________1_____C_______1__________________
55  ______________________________________________________________________________________________________________________________1____(133,54)_1___________________
56  _____________________________________________________________________________________________________________________________1_____________1____________________
57  ____________________________________________________________________________________________________________________________1_____________1_____________________
58  ____________________________________________________________________________________________________________________________1_____________1_____________________
59  ___________________________________________________________________________________________________________________________1_____________1______________________
60  __________________________________________________________________________________________________________________________1_____________1_______________________
61  _________________________________________________________________________________________________________________________1_____________1________________________
62  ________________________________________________________________________________________________________________________1______________1________________________
63  _______________________________________________________________________________________________________________________1______________1_________________________
64  _______________________________________________________________________________________________________________________1_____________1__________________________
65  ______________________________________________________________________________________________________________________1_____________1___________________________
66  _____________________________________________________________________________________________________________________1_____________1____________________________
67  ____________________________________________________________________________________________________________________1______________1____________________________
68  ___________________________________________________________________________________________________________________1______________1_____________________________
69  ___________________________________________________________________________________________________________________1_____________1______________________________
70  __________________________________________________________________________________________________________________1_____________1_______________________________
71  _________________________________________________________________________________________________________________1_____________1________________________________
72  ________________________________________________________________________________________________________________1______________1________________________________
73  _______________________________________________________________________________________________________________1______________1_________________________________
74  ______________________________________________________________________________________________________________1______________1__________________________________
75  ______________________________________________________________________________________________________________1_____________1___________________________________
76  _____________________________________________________________________________________________________________1______________1___________________________________
77  ____________________________________________________________________________________________________________1______________1____________________________________
78  ___________________________________________________________________________________________________________1______________1_____________________________________
79  __________________________________________________________________________________________________________1______________1______________________________________
80  _________________________________________________________________________________________________________1______________1_______________________________________
81  _________________________________________________________________________________________________________1______________1_______________________________________
82  ________________________________________________________________________________________________________1______________1________________________________________
83  _______________________________________________________________________________________________________1______________1_________________________________________
84  ______________________________________________________________________________________________________1______________1__________________________________________
85  _____________________________________________________________________________________________________1______________1___________________________________________
86  _____________________________________________________________________________________________________1______________1___________________________________________
87  ____________________________________________________________________________________________________1______________1____________________________________________
88  ___________________________________________________________________________________________________1______________1_____________________________________________
89  __________________________________________________________________________________________________1______________1______________________________________________
90  ______________________________________XXXXXXXXXXXXXXXX___________________________________________1______________1_______________________________________________
91  ______________________________________X______________X__________________________________________1_______________1_______________________________________________
92  ______________________________________X______________X__________________________________________1______________1________________________________________________
93  ______________________________________X______________X_________________________________________1______________1_________________________________________________
94  ______________________________________X______________X________________________________________1______________1__________________________________________________
95  ______________________________________X______________X_______________________________________1_______________1__________________________________________________
96  ______________________________________X______________X______________________________________1_______________1___________________________________________________
97  ______________________________________X______________X_____________________________________1_______________1____________________________________________________
98  ______________________________________X______________X_____________________________________1______________1_____________________________________________________
99  ______________________________________X______________X____________________________________1______________1______________________________________________________
100 ______________________________________X______________X___________________________________1_______________1______________________________________________________
101 ______________________________________X______________X__________________________________1_______________1_______________________________________________________
102 ______________________________________1111111111111111_________________________________1_______________1________________________________________________________
103 ______________________________________1______________1_________________________________1______________1_________________________________________________________
104 ______________________________________1______________1________________________________1______________1__________________________________________________________
105 ______________________________________1______________1_______________________________1_______________1__________________________________________________________
106 ______________________________________1______________1______________________________1_______________1___________________________________________________________
107 ______________________________________1______________1_____________________________1_______________1____________________________________________________________
108 ______________________________________1______________1____________________________1_______________1_____________________________________________________________
109 ______________________________________1______________1____________________________1______________1______________________________________________________________
110 ______________________________________1______________1___________________________1_______________1______________________________________________________________
111 ______________________________________1______________1_wizard bedroom___________1_______________1_______________________________________________________________
112 ______________________________________1______________1_(38, 90, 53, 118)_______1_______________1________________________________________________________________
113 ______________________________________1______________1________________________1_______________1_________________________________________________________________
114 ______________________________________1______________1_______________________1________________1_________________________________________________________________
115 ______________________________________1______________1_______________________1_______________1__________________________________________________________________
116 ______________________________________1______________1______________________1_______________1___________________________________________________________________
117 ______________________________________1______________1_____________111111111_______________1____________________________________________________________________
118 ______________________________________1XXXXXXXXXXXXXX1_____________1______________________1_____________________________________________________________________
119 ______________________________________1______________1_____________1______________________1_____________________________________________________________________
120 __________________________1111111111111_B____________111111111111111_____________________1______________________________________________________________________
121 __________________________1_____________(40,120)________________________________________1_______________________________________________________________________
122 ______________________1111______________________________________________________________1_______________________________________________________________________
123 ______________________1_______________________________________________________________11________________________________________________________________________
124 ______________________1______________________________________________________________1__________________________________________________________________________
125 _____________________1______________________________________________________________1___________________________________________________________________________
126 _____________________1______________________________________________________________1___________________________________________________________________________
127 _____________________1_____________________________________________________________1___________________________________________________bedroom__________________
128 _____________________1____________________________________________________________1____________________________________________________(139, 133, 159, 166)_____
129 ____________________1____________________________________________________________11_____________________________________________________________________________
130 ____________________1_____________________________________________________________1_____________________________________________________________________________
131 ____________________1_____________________________________________________________1_____________________________________________________________________________
132 ____________________1____________________________________________________________111111111111111111111111111111111111___1111111111111111111111111_11111111111111
133 ___________________1_________________________________________________________________________________________________1___1_________________XXXXXXXXXXXXXXXXXXXX1
134 ___________________1__________________________________________________________________________________________________1111________________PX___________________1 P = 138,134
135 ___________________1_______________________________________________________________________________________________________________________X___________________1
136 ___________________1_______________________________________________________________________________________________________________________X___________________1
137 __________________1________________________________________________________________________________________________________________________X___________________1
138 __________________1________________________________________________________________________________________________________________________X___________________1
139 __________________1________________________________________________________________________________________________________________________X___________________1
140 __________________1________________________________________________________________________________________________________________________X___________________1
141 _________________1_________________________________________________________________________________________________________________________X___________________1
142 _________________1_________________________________________________________________________________________________________________________X___________________1
143 _________________1_______________________________________________11111111111111111111111111111111111111____________________________________X___________________1
144 _________________1_______________________________________________1___________________________________11____________________________________X___________________1
145 _________________1_______________________________________________1__________________________________1_1____________________________________X___________________1
146 ________________1_________________________________________________1________________________________1__1____________________________________X___________________1
147 ________________1_________________________________________________1_______________________________1___1____________________________________X___________________1
148 ________________1_________________________________________________1______________________________1____1____________________________________X___________________1
149 ________________1_________________________________________________1_____________________________1_____1____________________________________X___________________1
150 _______________1___________________________________________________1___________________________1_____1_____________________________________X___________________1
151 _______________1___________________________________________________1___________________________1____1______________________________________X___________________1
152 _______________1___________________________________________________1__________________________1____1_______________________________________X___________________1
153 _______________1___________________________________________________1_________________________1____1________________________________________X___________________1
154 ______________1_____________________________________________________1_______________________1____1_________________________________________X___________________1
155 ______________1_____________________________________________________1______________________1____1__________________________________________X___________________1
156 ______________1_____________________________________________________1_____________________1____1___________________________________________X___________________1
157 ______________1_____________________________________________________1____________________1____1____________________________________________X___________________1
158 _____________1_______________________________________________________1__________________1____1_____________________________________________X___________________1
159 _____________1_______________________________________________________1_________________1_____1_____________________________________________X___________________1
160 _____________1_______________________________________________________1________________1_____1______________________________________________X___________________1
161 _____________1_______________________________________________________1_______________1_____1_______________________________________________X___________________1
162 ____________1_________________________________________________________1_____________1_____1________________________________________________X___________________1
163 ____________1_________________________________________________________1_____________1____1_________________________________________________X___________________1
164 ____________11111111111111111111111111111111111111111111111111111111111____________1____1_________________________1111111111111111111111111111111111111111111111
165 __________________________________________________________________________________1____1________________________11_________________________X___________________X
166 _________________________________________________________________________________1____1_________(90,167)_______1___________________________XXXXXXXXXXXXXXXXXXXXX
167 ________________________________________________________________________________1____1_________A______________1_________________________________________________






