    0         10        20        30        40        50        60        70        80        90        100       110       120       130       140       150       
    0123456789012345678901234567890123456789012345678901234567890123456789012345678901234567890123456789012345678901234567890123456789012345678901234567890123456789
0   ____________________________________________1111111111111111111111111111111111111111111111111111111111111_______________________________________________________
1   ____________________________________________1___________________________________________________________1_______________________________________________________
2   ___________________________________________1_____________________________________________________________1______________________________________________________
3   ___________________________________________1_____________________________________________________________1______________________________________________________
4   __________________________________________1_______________________________________________________________1_____________________________________________________
5   __________________________________________1_______________________________________________________________1_____________________________________________________
6   _________________________________________1________________________________________________________________1_____________________________________________________
7   _________________________________________1_________________________________________________________________1____________________________________________________
8   _________________________________________1_________________________________________________________________1____________________________________________________
9   ________________________________________1___________________________________________________________________1___________________________________________________
10  ________________________________________1___________________________________________________________________1___________________________________________________
11  _______________________________________1____________________________________________________________________1___________________________________________________
12  _______________________________________1_____________________________________________________________________1__________________________________________________
13  _______________________________________1_____________________________________________________________________1__________________________________________________
14  ______________________________________1_______________________________________________________________________1_________________________________________________
15  ______________________________________1_______________________________________________________________________1_________________________________________________
16  _____________________________________1________________________________________________________________________1_________________________________________________
17  _____________________________________1_________________________________________________________________________1________________________________________________
18  ____________________________________1__________________________________________________________________________1________________________________________________
19  ____________________________________1___________________________________________________________________________1_______________________________________________
20  ____________________________________1___________________________________________________________________________1_______________________________________________
21  ___________________________________1____________________________________________________________________________1_______________________________________________
22  ___________________________________1_____________________________________________________________________________1______________________________________________
23  __________________________________1______________________________________________________________________________1______________________________________________
24  __________________________________1_______________________________________________________________________________1_____________________________________________
25  _________________________________1________________________________________________________________________________1_____________________________________________
26  _________________________________1________________________________________________________________________________1_____________________________________________
27  _________________________________1_________________________________________________________________________________1____________________________________________
28  ________________________________1__________________________________________________________________________________1____________________________________________
29  ________________________________1___________________________________________________________________________________1___________________________________________
30  _______________________________1____________________________________________________________________________________1___________________________________________
31  _______________________________1____________________________________________________________________________________1___________________________________________
32  _______________________________1_____________________________________________________________________________________1__________________________________________
33  ______________________________1______________________________________________________________________________________1__________________________________________
34  ______________________________1_______________________________________________________________________________________1_________________________________________
35  _____________________________1________________________________________________________________________________________1_________________________________________
36  _____________________________1_________________________________________________________________________________________1________________________________________
37  ____________________________1__________________________________________________________________________________________1________________________________________
38  ____________________________1__________________________________________________________________________________________1________________________________________
39  ____________________________1___________________________________________________________________________________________1_______________________________________
40  ___________________________1____________________________________________________________________________________________1_______________________________________
41  ___________________________1_____________________________________________________________________________________________1______________________________________
42  __________________________1______________________________________________________________________________________________1______________________________________
43  __________________________1______________________________________________________________________________________________1______________________________________
44  _________________________1________________________________________________________________________________________________1_____________________________________
45  _________________________1________________________________________________________________________________________________1_____________________________________
46  _________________________1_________________________________________________________________________________________________1____________________________________
47  ________________________1__________________________________________________________________________________________________1____________________________________
48  ________________________1__________________________________________________________________________________________________1____________________________________
49  _______________________1____________________________________________________________________________________________________1___________________________________
50  _______________________1____________________________________________________________________________________________________1___________________________________
51  _______________________1_____________________________________________________________________________________________________1__________________________________
52  ______________________1______________________________________________________________________________________________________1__________________________________
53  ______________________1______________________________________________________________________________________________________1__________________________________
54  _____________________1________________________________________________________________________________________________________1_________________________________
55  _____________________1________________________________________________________________________________________________________1_________________________________
56  ____________________1__________________________________________________________________________________________________________1________________________________
57  ____________________1__________________________________________________________________________________________________________1________________________________
58  ____________________1__________________________________________________________________________________________________________1________________________________
59  ____________________1___________________________________________________________________________________________________________1_______________________________
60  ____________________1___________________________________________________________________________________________________________1_______________________________
61  ____________________1____________________________________________________________________________________________________________1______________________________
62  ____________________1____________________________________________________________________________________________________________1______________________________
63  ____________________1____________________________________________________________________________________________________________1______________________________
64  _____________________1______________________________________11111111111111111111111111111_________________________________________1_____________________________
65  _____________________1______________________________________1___________________________1_________________________________________1_____________________________
66  _____________________1______________________________________1___________________________1__________________________________________1____________________________
67  _____________________1______________________________________1___________________________1__________________________________________1____________________________
68  _____________________1______________________________________1___________________________1__________________________________________1____________________________
69  _____________________1______________________________________1___________________________1___________________________________________1___________________________
70  _____________________1______________________________________1___________________________1___________________________________________1___________________________
71  _____________________1______________________________________1___________________________1____________________________________________1__________________________
72  _____________________1______________________________________1___________________________1____________________________________________1__________________________
73  _____________________1______________________________________1___________________________1____________________________________________1__________________________
74  _____________________1______________________________________1___________________________1____________________________________________1__________________________
75  _____________________1______________________________________1___________________________1____________________________________________1__________________________
76  _____________________1______________________________________1___________________________1____________________________________________1__________________________
77  _____________________1______________________________________1___________________________1____________________________________________1__________________________
78  ______________________1_____________________________________1___________________________1___________________________________________1___________________________
79  ______________________1_____________________________________1___________________________1___________________________________________1___________________________
80  ______________________1_____________________________________1___________________________1___________________________________________1___________________________
81  ______________________1_____________________________________1___________________________1___________________________________________1___________________________
82  ______________________1_____________________________________1___________________________1___________________________________________1___________________________
83  ______________________1_____________________________________11111111111111111111111111111___________________________________________1___________________________
84  ______________________1_____________________________________________________________________________________________________________1___________________________
85  ______________________1_____________________________________________________________________________________________________________1___________________________
86  ______________________1_____________________________________________________________________________________________________________1___________________________
87  ______________________1_____________________________________________________________________________________________________________1___________________________
88  ______________________1________________________________________11111111111111111111111______________________________________________1___________________________
89  ______________________1_____________________________________111_______________________11111_________________________________________1___________________________
90  ______________________1_________________________________1111_______________________________11111___________________________________1____________________________
91  ______________________1_______________________________11________________________________________1111_______________________________1____________________________
92  _______________________1_____________________________1______________________________________________1111___________________________1____________________________
93  _______________________1____________________________1___________________________________________________11_________________________1____________________________
94  _______________________1___________________________1______________________________________________________11_______________________1____________________________
95  _______________________1_________________________11_________________________________________________________1______________________1____________________________
96  _______________________1________________________1____________________________________________________________1_____________________1____________________________
97  _______________________1_______________________1______________________________________________________________11___________________1____________________________
98  _______________________1______________________1_________________________________________________________________1__________________1____________________________
99  _______________________1_____________________1___________________________________________________________________1_________________1____________________________
100 _______________________1____________________1_____________________________________________________________________11_______________1____________________________
101 _______________________1____________________1_______________________________________________________________________1______________1____________________________
102 _______________________1___________________1_________________________________________________________________________1____________1_____________________________
103 _______________________1__________________1___________________________________________________________________________1___________1_____________________________
104 _______________________1_________________1_____________________________________________________________________________1__________1_____________________________
105 _______________________1________________1______________________________________________________________________________1__________1_____________________________
106 ________________________1______________1________________________________________________________________________________1_________1_____________________________
107 ________________________1______________1_________________________________________________________________________________1________1_____________________________
108 ________________________1_____________1___________________________________________________________________________________1_______1_____________________________
109 ________________________1____________1____________________________________________________________________________________1_______1_____________________________
110 ________________________1___________1______________________________________________________________________________________1______1_____________________________
111 ________________________1__________1_________________________111111111______________________________________________________1_____1_____________________________
112 ________________________1__________1_________________________1________11111111______________________________________________1_____1_____________________________
113 ________________________1_________1__________________________1________________11_____________________________________________1____1_____________________________
114 ________________________1__________1_________________________1__________________11___________________________________________1___1______________________________
115 ________________________1__________1_________________________1____________________11_________________________________________1___1______________________________
116 ________________________1__________1_________________________1______________________1_________________________________________1__1______________________________
117 ________________________1__________1_________________________1_______________________11_______________________________________1__1______________________________
118 ________________________1__________1_________________________1_________________________11_____________________________________1__1______________________________
119 _________________________1________1__________________________11_________________________11_____________________________________1_1______________________________
120 _________________________1________1____________________________11______________________1_______________________________________1_1______________________________
121 _________________________1________1______________________________11____________________1_______________________________________1_1______________________________
122 _________________________1________1________________________________111________________1_________________________________________11______________________________
123 _________________________1________1___________________________________1111_______11111__________________________________________11______________________________
124 _________________________1________1_______________________________________1111111_______________________________________________11______________________________
125 _________________________1________1_____________________________________________________________________________________________11______________________________
126 _________________________1________1_____________________________________________________________________________________________1_______________________________
127 _________________________1________1____________________________________________________________________________________________11_______________________________
128 _________________________1________1____________________________________________________________________________________________11_______________________________
129 _________________________1_______1_____________________________________________________________________________________________11_______________________________
130 _________________________1_______1_____________________________________________________________________________________________11_______________________________
131 _________________________1_______1_____________________________________________________________________________________________11_______________________________
132 _________________________1_______1_____________________________________________________________________________________________11_______________________________
133 __________________________1______1_____________________________________________________________________________________________11_______________________________
134 __________________________1______1____________________________________________________________________________________________1_1_______________________________
135 __________________________1______1____________________________________________________________________________________________1_1_______________________________
136 __________________________1______1____________________________________________________________________________________________1_1_______________________________
137 __________________________1_______1___________________________________________________________________________________________1_1_______________________________
138 __________________________1_______1___________________________________________________________________________________________11________________________________
139 __________________________1_______1___________________________________________________________________________________________11________________________________
140 __________________________1_______1__________________________________________________________________________________________1_1________________________________
141 __________________________1_______1__________________________________________________________________________________________1_1________________________________
142 __________________________1_______1__________________________________________________________________________________________1_1________________________________
143 __________________________1________1_________________________________________________________________________________________1_1________________________________
144 __________________________1________1_________________________________________________________________________________________1_1________________________________
145 __________________________1________1________________________________________________________________________________________1__1________________________________
146 __________________________1________1________________________________________________________________________________________1__1________________________________
147 ___________________________1_______1________________________________________________________________________________________1__1________________________________
148 ___________________________1_______1_______________________________________________________________________________________1___1________________________________
149 ___________________________1________1______________________________________________________________________________________1___1________________________________
150 ___________________________1________1______________________________________________________________________________________1__1_________________________________
151 ___________________________1________1_____________________________________________________________________________________1___1_________________________________
152 ___________________________1________1_____________________________________________________________________________________1___1_________________________________
153 ___________________________1_________11___________________________________________________________________________________1___1_________________________________
154 ___________________________1___________11________________________________________________________________________________1____1_________________________________
155 ___________________________1_____________1______________________________________________________________________________11____1_________________________________
156 ___________________________1______________11_________________________________________________________________________111______1_________________________________
157 ___________________________1________________1______________________________________________________________________11_________1_________________________________
158 ___________________________1_________________11_________________________________________________________________111___________1_________________________________
159 ___________________________1___________________11____________________________________________________________111______________1_________________________________
160 ___________________________1_____________________11________________________________________________________11_________________1_________________________________
161 ____________________________1______________________111________________________________________________11111___________________1_________________________________
162 ____________________________1_________________________11________________________________________111111_______________________1__________________________________
163 ____________________________1___________________________111_______________________________111111_____________________________1__________________________________
164 ____________________________1______________________________11__________________________111___________________________________1__________________________________
165 ____________________________1_______________________________1__________________________1_____________________________________1__________________________________
166 ____________________________1_______________________________1__________________________1_____________________________________1__________________________________
167 ____________________________1_______________________________1__________________________1_____________________________________1__________________________________
