    0         10        20        30        40        50        60        70        80        90        100       110       120       130       140       150       
    0123456789012345678901234567890123456789012345678901234567890123456789012345678901234567890123456789012345678901234567890123456789012345678901234567890123456789
0   ________________________________________________________________________________________________________________________________________________________________
1   ________________________________________________________________________________________________________________________________________________________________
2   ________________________________________________________________________________________________________________________________________________________________
3   ________________________________________________________________________________________________________________________________________________________________
4   ________________________________________________________________________________________________________________________________________________________________
5   ________________________________________________________________________________________________________________________________________________________________
6   ________________________________________________________________________________________________________________________________________________________________
7   ________________________________________________________________________________________________________________________________________________________________
8   ________________________________________________________________________________________________________________________________________________________________
9   ________________________________________________________________________________________________________________________________________________________________
10  ________________________________________________________________________________________________________________________________________________________________
11  ________________________________________________________________________________________________________________________________________________________________
12  ________________________________________________________________________________________________________________________________________________________________
13  ______________________________________________________________________________________________________________________________________________________________1_
14  ______________________________________________________________________________________________________________________________________________________________1_
15  ______________________________________________________________________________________________________________________________________________________________1_
16  ______________________________________________________________________________________________________________________________________________________________1_
17  ______________________________________________________________________________________________________________________________________________________________1_
18  ____________________________________________1_________________________________________________________________________________________________________________1_
19  ___________________________________________1__________________________________________________________________________________________________________________1_
20  __________________________________________1___________________________________________________________________________________________________________________1_
21  __________________________________________1___________________________________________________________________________________________________________________1_
22  _________________________________________1____________________________________________________________________________________________________________________1_
23  _________________________________________1____________________________________________________________________________________________________________________1_
24  _________________________________________1____________________________________________________________________________________________________________________1_
25  _________________________________________1____________________________________________________________________________________________________________________1_
26  _________________________________________1____________________________________________________________________________________________________________________1_
27  _________________________________________1____________________________________________________________________________________________________________________1_
28  _________________________________________1____________________________________________________________________________________________________________________1_
29  _________________________________________1____________________________________________________________________________________________________________________1_
30  ________________________________________1_____________________________________________________________________________________________________________________1_
31  ________________________________________1_____________________________________________________________________________________________________________________1_
32  ________________________________________1_____________________________________________________________________________________________________________________1_
33  ________________________________________1_____________________________________________________________________________________________________________________1_
34  ________________________________________1_____________________________________________________________________________________________________________________1_
35  ________________________________________1_____________________________________________________________________________________________________________________1_
36  ________________________________________1_____________________________________________________________________________________________________________________1_
37  ________________________________________1_____________________________________________________________________________________________________________________1_
38  ________________________________________1_____________________________________________________________________________________________________________________1_
39  _______________________________________1______________________________________________________________________________________________________________________1_
40  _______________________________________1______________________________________________________________________________________________________________________1_
41  ______________________________________1_______________________________________________________________________________________________________________________1_
42  ______________________________________1_______________________________________________________________________________________________________________________1_
43  _____________________________________1________________________________________________________________________________________________________________________1_
44  _____________________________________1________________________________________________________________________________________________________________________1_
45  ____________________________________1_________________________________________________________________________________________________________________________1_
46  ____________________________________1_________________________________________________________________________________________________________________________1_
47  ___________________________________1_______________________________________________________________________________________________________11111111111111111111_
48  ___________________________________1_______________________________________________________________________________________________________1111111______________
49  __________________________________1_______________________________________________________________________________________________________________11____________
50  __________________________________1_________________________________________________________________________________________________________________111_________
51  _________________________________1_____________________________________________________________________________________________________________________1111_____
52  _________________________________1_________________________________________________________________________________________________________________________111__
53  ________________________________1____________________________________________________________________________________________________________________________1__
54  ________________________________1____________________________________________________________________________________________________________________________1__
55  _______________________________1______________________________________________________________________________________________________________________________1_
56  _______________________________1______________________________________________________________________________________________________________________________1_
57  ________________________________1________________________________________________________1111111111_____________________________________________111111111111111_
58  _______________________________1_____________________________________________________1111__________11111________________________________________1_______________
59  _______________________________1___________________________________________________11___________________111_____________________________________111111111111111_
60  ______________________________1______________________________________________________1_______________1111_____________________________________________________1_
61  ______________________________1_______________________________________________________111111111111111_________________________________________________________1_
62  _____________________________1________________________________________________________________________________________________________________________________1_
63  _____________________________1________________________________________________________________________________________________________________________________1_
64  ____________________________1_________________________________________________________________________________________________________________________________1_
65  ____________________________1_________________________________________________________________________________________________________________________________1_
66  ___________________________1__________________________________________________________________________________________________________________________________1_
67  ___________________________1__________________________________________________________________________________________________________________________________1_
68  __________________________1___________________________________________________________________________________________________________________________________1_
69  __________________________1_________________________________________________________________________________________________________________________________111_
70  _________________________1______________________________________________________________________________________________________________________________1111____
71  _________________________1__________________________________________________________________________________________________________________________1111________
72  ________________________1________________________________________________________________________________________________________________________111____________
73  _______________________1_________________________________________________________________________________________________________________________1______________
74  _______________________1_________________________________________________________________________________________________________________________1111___________
75  ______________________1______________________________________________________________________________________________________________________________1111111111_
76  ______________________1_______________________________________________________________________________________________________________________________________1_
77  _____________________1________________________________________________________________________________________________________________________________________1_
78  _____________________1________________________________________________________________________________________________________________________________________1_
79  ____________________1_______________________________________________________________________________________________________________________________________111_
80  ____________________1__________________________________________________________________________________________________________________________________11111____
81  ___________________1______________________________________________________________________________________________________________________________11111_________
82  ___________________1________________________________________________________________________________________________________________________111111______________
83  __________________1______________________________________________________________________________________________________________________111____________________
84  __________________1________________________________________________________________________________________________________________________1111111111___________
85  _________________1__________________________________________________________________________________________________________________________________1___________
86  _________________1__________________________________________________________________________________________________________________________________1___________
87  _______________11___________________________________________________________________________________________________________________________________111111______
88  _______________1__________________________________________________________________________________________________________________________________________11111_
89  _______________1______________________________________________________________________________________________________________________________________________1_
90  ______________1_______________________________________________________________________________________________________________________________________________1_
91  ______________1_______________________________________________________________________________________________________________________________________________1_
92  ______________1_______________________________________________________________________________________________________________________________________________1_
93  ______________1______________________________________________________________________________________________________________________________________________11_
94  ______________1________________________________________________________________________________________________________________________1_________________1111___
95  _____________1________________________________________________________________________________________________________________________1_1______________11_______
96  _____________1________________________________________________________________________________________________________________________1__1_____________11111____
97  _____________1_______________________________________________________________________________________________________________________1____1_________________1111
98  ____________1_______________________________________________________________________________________________________________________11111111____________________
99  ____________1___________________________________________________________________________________________________________________________________________________
100 ____________1___________________________________________________________________________________________________________________________________________________
101 ___________1____________________________________________________________________________________________________________________________________________________
102 ___________1____________________________________________________________________________________________________________________________________________________
103 ___________1____________________________________________________________________________________________________________________________________________________
104 __________1_____________________________________________________________________________________________________________________________________________________
105 __________1_____________________________________________________________________________________________________________________________________________________
106 __________1_____________________________________________________________________________________________________________________________________________________
107 __________1_____________________________________________________________________________________________________________________________________________________
108 _________1______________________________________________________________________________________________________________________________________________________
109 _________1______________________________________________________________________________________________________________________________________________________
110 _________1______________________________________________________________________________________________________________________________________________________
111 _________1______________________________________________________________________________________________________________________________________________________
112 _________1______________________________________________________________________________________________________________________________________________________
113 _________1______________________________________________________________________________________________________________________________________________________
114 ________1_______________________________________________________________________________________________________________________________________________________
115 ________1____________________111111111111111____________________________________________________________________________________________________________________
116 ________1___________________1_______________111111111111111_____________________________________________________________________________________________________
117 ________1___________________1______________________________1___________________________________________________________1111111111_______________________________
118 ________1__________________1_______________________________1________________________________________________________111__________11_________________111_________
119 ________1_________________1_________________________________1_____________________________________________________11_______________11_____________11___11_______
120 _______1__________________1_________________________________1_____________________________________________________111111_____________1__________1111_____11_____
121 _______1_________________1___________________________________1__________________________________________________________11______111111______________11111_______
122 _______1________________1_____________________________________1___________________________________________________________111111________________________________
123 _______1________________1_____________________________________1_________________________________________________________________________________________________
124 _______1_______________1_______________________________________1________________________________________________________________________________________________
125 _______1_______________1________________________________________1_______________________________________________________________________________________________
126 ______1_______________1_________________________________________1_______________________________________________________________________________________________
127 ______1______________1___________________________________________1______________________________________________________________________________________________
128 ______1______________1___________________________________________1______________________________________________________________________________________________
129 ______1_____________1_____________________________________________1_____________________________________________________________________________________________
130 ______1____________1_______________________________________________1____________________________________________________________________________________________
131 ______1____________1_______________________________________________1____________________________________________________________________________________________
132 ______1___________1_________________________________________________1___________________________________________________________________________________________
133 ______1___________1________________________________________________1____________________________________________________________________________________________
134 ______1____________1_______________________________________________1____________________________________________________________________________________________
135 _____1_____________1______________________________________________1_____________________________________________________________________________________________
136 _____1______________1_____________________________________________1_____________________________________________________________________________________________
137 _____1______________1____________________________________________1______________________________________________________________________________________________
138 _____1_______________1__________________________________________1_______________________________________________________________________________________________
139 _____1_______________1__________________________________________1_______________________________________________________________________________________________
140 _____1________________1________________________________________1________________________________________________________________________________________________
141 _____1________________1_______________________________________1_________________________________________________________________________________________________
142 _____1_________________1______________________________________1_________________________________________________________________________________________________
143 _____1_________________1_____________________________________1__________________________________________________________________________________________________
144 _____1__________________1____________________________________1__________________________________________________________________________________________________
145 _____1__________________1111111111111111111111111111111111111___________________________________________________________________________________________________
146 _____1__________________________________________________________________________________________________________________________________________________________
147 _____1__________________________________________________________________________________________________________________________________________________________
148 _____1__________________________________________________________________________________________________________________________________________________________
149 ____1___________________________________________________________________________________________________________________________________________________________
150 ____1__________________________________________________________________________________________________________________________________________1111111_______111
151 ____1_______________________________________________________________________________________________________________________________________111_______1111111___
152 ____1___________________________________________________________________________________________________________11_______________________111_____________2222222
153 ____1_______________________________________________________________________________________________________1111__11__________________111________22222222_______
154 ____1______________________________________________________________________________________________111111111________11______________11_________21111111111111111
155 ____1_________________________________111___________________________111111_________________11111111_________2222______1111111______1________2211________________
156 ____11111_______________________111111___11___22222___________111111______11111__________11_________22222222111122___________111111______22211__________________
157 11111____11111_________111111111_________222221111_222__111111_______22222_____11111___11______2222211111111____1_2222222222___________22_11____________________
158 111_1222______111111111___________222222111111____111121_______222222_111_22________111______2211111_____________1111111111122222222222_11______________________
159 ___1111_222222_____________2222222111111______1111__11_22222222___1111___111222____________22_1_____________________________111111111111________________________
160 ____1__1111___22222222222221111111____________________111111111111__________11_222222222222__1__________________________________________________________________
161 ____1______1111_____1111111___________________________________________________111111111111111___________________________________________________________________
162 ____1__________11111____________________________________________________________________________________________________________________________________________
163 ____1___________________________________________________________________________________________________________________________________________________________
164 ____1___________________________________________________________________________________________________________________________________________________________
165 ____1___________________________________________________________________________________________________________________________________________________________
166 ____1___________________________________________________________________________________________________________________________________________________________
167 ____1___________________________________________________________________________________________________________________________________________________________
