    0         10        20        30        40        50        60        70        80        90        100       110       120       130       140       150       
    0123456789012345678901234567890123456789012345678901234567890123456789012345678901234567890123456789012345678901234567890123456789012345678901234567890123456789
0   ________________________________________________________________________________________________________________________________________________________________
1   ________________________________________________________________________________________________________________________________________________________________
2   ________________________________________________________________________________________________________________________________________________________________
3   ________________________________________________________________________________________________________________________________________________________________
4   ________________________________________________________________________________________________________________________________________________________________
5   ________________________________________________________________________________________________________________________________________________________________
6   ________________________________________________________________________________________________________________________________________________________________
7   ________________________________________________________________________________________________________________________________________________________________
8   ________________________________________________________________________________________________________________________________________________________________
9   ________________________________________________________________________________________________________________________________________________________________
10  ________________________________________________________________________________________________________________________________________________________________
11  ________________________________________________________________________________________________________________________________________________________________
12  ________________________________________________________________________________________________________________________________________________________________
13  ________________________________________________________________________________________________________________________________________________________________
14  ________________________________________________________________________________________________________________________________________________________________
15  ________________________________________________________________________________________________________________________________________________________________
16  ________________________________________________________________________________________________________________________________________________________________
17  ________________________________________________________________________________________________________________________________________________________________
18  ________________________________________________________________________________________________________________________________________________________________
19  ________________________________________________________________________________________________________________________________________________________________
20  ________________________________________________________________________________________________________________________________________________________________
21  ________________________________________________________________________________________________________________________________________________________________
22  ________________________________________________________________________________________________________________________________________________________________
23  ________________________________________________________________________________________________________________________________________________________________
24  ________________________________________________________________________________________________________________________________________________________________
25  ________________________________________________________________________________________________________________________________________________________________
26  ________________________________________________________________________________________________________________________________________________________________
27  ________________________________________________________________________________________________________________________________________________________________
28  ________________________________________________________________________________________________________________________________________________________________
29  ________________________________________________________________________________________________________________________________________________________________
30  ________________________________________________________________________________________________________________________________________________________________
31  ________________________________________________________________________________________________________________________________________________________________
32  ________________________________________________________________________________________________________________________________________________________________
33  ________________________________________________________________________________________________________________________________________________________________
34  ________________________________________________________________________________________________________________________________________________________________
35  ________________________________________________________________________________________________________________________________________________________________
36  ________________________________________________________________________________________________________________________________________________________________
37  ________________________________________________________________________________________________________________________________________________________________
38  ________________________________________________________________________________________________________________________________________________________________
39  ________________________________________________________________________________________________________________________________________________________________
40  ________________________________________________________________________________________________________________________________________________________________
41  ________________________________________________________________________________________________________________________________________________________________
42  ________________________________________________________________________________________________________________________________________________________________
43  ________________________________________________________________________________________________________________________________________________________________
44  ________________________________________________________________________________________________________________________________________________________________
45  ________________________________________________________________________________________________________________________________________________________________
46  ________________________________________________________________________________________________________________________________________________________________
47  ________________________________________________________________________________________________________________________________________________________________
48  _________________________________________________________________________________33_____________________________________________________________________________
49  _______________________________________________________________________________3333_____________________________________________________________________________
50  _____________________________________________________________________________333333_____________________________________________________________________________
51  ___________________________________________________________________________333333_______________________________________________________________________________
52  _________________________________________________________________________33333__________________________________________________________________________________
53  ________________________________________________________________________333333__________________________________________________________________________________
54  ______________________________________________________________________3333333___________________________________________________________________________________
55  ______________________________________________________________________3333333___________________________________________________________________________________
56  _____________________________________________________________________33333333___________________________________________________________________________________
57  _____________________________________________________________________333333333__________________________________________________________________________________
58  ________11111111111111111111__________________________________________3333333333______________________________________________1111______________________________
59  ______11____111111111111___1____________________________________________3333333333__________________________________________11____11111_________________________
60  ________1111____________111________________________________________________333333333_________________________________________1______11__________________________
61  ______________________________________________________________________________333333_________________________________________1____11____________________________
62  __________________________________________________________________________________33_________33_______________________________1111______________________________
63  _____________________________________________________________________________________________33333______________________________________________________________
64  _____________________________________________________________________________________________33333333___________________________________________________________
65  ______________________________________________________________________________________________33333333__________________________________________________________
66  ________________________________________________________________________________________________3333333_________________________________________________________
67  ___________________________________________________________________________________________________3333___3_____________________________________________________
68  ____________________________________________________________________________________________________333___33____________________________________________________
69  ___________________________11111111111111111111111___________________________________________________33___33____________________________________________________
70  ___________________________1_____________________1____________________________________________________3___333___11111111111111__________________________________
71  ___________________________1_____________________1________________________________________________________3333__111___________111_______________________________
72  ___________________________11111111111111111111111________________________________________________________333333___111111____11_________________________________
73  __________________________________________________________________________________________________________3333333333_____1111___333_____________________________
74  ____________________________________________________________________________________________________________333333333333_____33333333___________________________
75  _______________________________________________________________________________________________________________3333333333333333333333333________________________
76  __________________________________________________________________________________________________________________333333333333333333333333______________________
77  ______________________________________________________________________________________________________________________3333333333333333333333____________________
78  ____________________________________________________________________________________________________________________________333333333333333333__________________
79  ________________________________________________________________________________________________________________________________3333333333333333________________
80  __________________________________________________________________________________________________________________________________333333333333333_______________
81  ____________________________________________________________________________________11111__________________________________________33333333333111111111111111111
82  ______________________________________________111111111111111111______________111111_____1111_________________________________33333333333333331133_1___1___1___1
83  ______________________________________________1________________1__________1111_______________111_________________________3333333333333333333331133_1___1___1___1
84  ______________________________________________111111111111111111___________11111111111__1111111_________________________333333333333333333____111111111111111111
85  _____________________________________________________________________________________1__1______________________________3333333333_______________________________
86  ______________________________________________________________________________________1_1_____________________________33333333__________________________________
87  ______________________________________________________________________________________1_1___________________________33333333____________________________________
88  ______________________________________________________________________________________11__________________________333333333_____________________________________
89  ______________________________________________________________________________________11________________________3333333333______________________________________
90  _______________________________________________________________________________________1________________________333333333_______________________________________
91  _______________________________________________________________________________________1________________________333333333_______________________________________
92  ____________________________________________________________________________________________________________________33333_______________________________________
93  ______________________________111111111111111_______________________________________________________________________333333______________________________________
94  ____________________________11_______________11______________________________________________________________________333333_____________________________________
95  __________________________11___________________11_________________________________________________________________________3_____________________________________
96  __________________________11111111111111111111111__________________________________________________________________________3____________________________________
97  ___________________________________________________________________________________________________________________________33___________________________________
98  ____________________________________________________________________________________________________________________________33__________________________________
99  ____________________________________________________________________________________________________________________________3333________________________________
100 _____________________________________________________________________________________________________________________________333333_____________________________
101 _____________________________________________________________________________________________________________________________333333_____________________________
102 ______________________________________________________________________________________________________________________________33333_____________________________
103 ______________________________________________________________________________________________________________________________3333______________________________
104 11111111111111111_____________________________________________________________________________________________________________3333______________________________
105 __11____1111____1_____________________________________________________________________________________________________________3333______________________________
106 ____1111____111_1_____________________________________________________________________________________________________________333_______________________________
107 11111111111111111_____________________________________________________________________________________________________________333_______________________________
108 ______________________________________________________________________________________________________________________________333_______________________________
109 _______________________________________________________________________________________________________________________________33_______________________________
110 _______________________________________________________________________________________________________________________________33_______________________________
111 ________________________________________________________________________________________________________________________________________________________________
112 ___________________________________________________________________________________________________________________________________________3____________________
113 ___________________________________________________________________________________________________________________________________________333__________________
114 ___________________________________________________________________________________________________________________________________________33333________________
115 11111111111111111__________________________________________________________________________________________________________________________3333333______________
116 ___1___1___1___1_11___________________________________________________________________________________________________________________1____3333333______________
117 ___1___1___1___1___11_____________________________________________________________________________________________________________1111_11__333333_______________
118 ___1___1___1___1____1__________________________________________________________________________________________________________111_______11333333_______________
119 ___1___1___1___1___11__________________________________________________________________________________________________________1111_____111333333_______________
120 1111111111111111111________________________________________________________________________________________________________________11111____33333_______________
121 _____________________________________________________________________________________________________________________________________________3333_______________
122 _______________________________________________________________________________________________________________________________________________33_______________
123 ________________________________________________________________________________________________________________________________________________33______________
124 _______________________________________________________________________________________________________________________________________________333______________
125 _____________________________________________________________________________________________________________________________________________3333_______________
126 __________________________________________________________________________________________________________________________________________3333333_______________
127 ________________________________________________________________________________________________________________________________________33333333___1111111111111
128 ________________________________________________________________________________________________________________________________________33333333_11_____________
129 ________________________________________________________________________________________________________________________________________333333331_______________
130 _________________________________________________________________________________________________________________________________________3333333311_____________
131 _________________________________________________________________________________________________________________________________________33333333331____________
132 __________________________________________________________________________________________________________________________________________3333333333111111111111
133 __________________________________________________________________________________________________________________________________________333__33333____________
134 __________________________________________________________________________________________________________________________________________________3_____________
135 ________________________________________________________________________________________________________________________________________________________________
136 ________________________________________________________________________________________________________________________________________________________________
137 ________________________________________________________________________________________________________________________________________________________________
138 ________________________________________________________________________________________________________________________________________________________________
139 ________________________________________________________________________________________________________________________________________________________________
140 ________________________________________________________________________________________________________________________________________________________________
141 ________________________________________________________________________________________________________________________________________________________________
142 ________________________________________________________________________________________________________________________________________________________________
143 ________________________________________________________________________________________________________________________________________________________________
144 ________________________________________________________________________________________________________________________________________________________________
145 ______________________________________________111111111111111111111111111111111111111111111111111111111111111111111111111111111111111111111111111111111111111111
146 _____________________________________________1__________________________________________________________________________________________________________________
147 ____________________________________________1___________________________________________________________________________________________________________________
148 ___________________________________________1____________________________________________________________________________________________________________________
149 __________________________________________1_____________________________________________________________________________________________________________________
150 _________________________________________1______________________________________________________________________________________________________________________
151 ________________________________________1_______________________________________________________________________________________________________________________
152 ______________________________1111111111________________________________________________________________________________________________________________________
153 ______________________________1___1___1_________________________________________________________________________________________________________________________
154 _____________________________11___1___1_________________________________________________________________________________________________________________________
155 _____________________________11___1___1_________________________________________________________________________________________________________________________
156 1111111111111_______________1_1___1___1_________________________________________________________________________________________________________________________
157 ________1___1_______________1_1___1___1_________________________________________________________________________________________________________________________
158 ________1___1______________1__1___1___1_________________________________________________________________________________________________________________________
159 ________1___11_____________1__1___1___1_________________________________________________________________________________________________________________________
160 ________1___11____________1___1___1___1_________________________________________________________________________________________________________________________
161 ________1___1_111111111111111_1___1___1_________________________________________________________________________________________________________________________
162 ________1___1___1___1___1___1_1___1___1_________________________________________________________________________________________________________________________
163 ________1___1___1___1___1___1_1___1___1_________________________________________________________________________________________________________________________
164 ________1___1___1___1___1___1_1___1___1_________________________________________________________________________________________________________________________
165 ________1___1___1___1___1___1_1___1___1_________________________________________________________________________________________________________________________
166 ________1___1___1___1___1___1_1___1___1_________________________________________________________________________________________________________________________
167 ________1___11111___11111___111___11111_________________________________________________________________________________________________________________________
