    0         10        20        30        40        50        60        70        80        90        100       110       120       130       140       150
    0123456789012345678901234567890123456789012345678901234567890123456789012345678901234567890123456789012345678901234567890123456789012345678901234567890123456789
0   ________________________________________2________________________1______________________________________________________________________________________________
1   ________________________________________2________________________1______________________________________________________________________________________________
2   ________________________________________2________________________1______________________________________________________________________________________________
3   ________________________________________2________________________1______________________________________________________________________________________________
4   ________________________________________2________________________1______________________________________________________________________________________________
5   ________________________________________2________________________1______________________________________________________________________________________________
6   ________________________________________2________________________1______________________________________________________________________________________________
7   ________________________________________2________________________1______________________________________________________________________________________________
8   ________________________________________2________________________1______________________________________________________________________________________________
9   ________________________________________2________________________1______________________________________________________________________________________________
10  ________________________________________2________________________1______________________________________________________________________________________________
11  ________________________________________2________________________1______________________________________________________________________________________________
12  ________________________________________2________________________1______________________________________________________________________________________________
13  ________________________________________2________________________1______________________________________________________________________________________________
14  ________________________________________2________________________1______________________________________________________________________________________________
15  ________________________________________2________________________1______________________________________________________________________________________________
16  ________________________________________2________________________1______________________________________________________________________________________________
17  ________________________________________2________________________1______________________________________________________________________________________________
18  ________________________________________2________________________1______________________________________________________________________________________________
19  ________________________________________2________________________1______________________________________________________________________________________________
20  ________________________________________2________________________1______________________________________________________________________________________________
21  ________________________________________2________________________1______________________________________________________________________________________________
22  ________________________________________2________________________1______________________________________________________________________________________________
23  ________________________________________2________________________1______________________________________________________________________________________________
24  ________________________________________2________________________1______________________________________________________________________________________________
25  ________________________________________2________________________1______________________________________________________________________________________________
26  ________________________________________2________________________1______________________________________________________________________________________________
27  ________________________________________2________________________1______________________________________________________________________________________________
28  ________________________________________2________________________1______________________________________________________________________________________________
29  ________________________________________2________________________1______________________________________________________________________________________________
30  ________________________________________2________________________1______________________________________________________________________________________________
31  ________________________________________2_______________________1_______________________________________________________________________________________________
32  ________________________________________2_______________________1_______________________________________________________________________________________________
33  ________________________________________2_______________________1______________________222______________________________________________________________________
34  ________________________________________2_______________________1____________________22___2222___________2222___________________________________________________ HORIZON
35  ________________________________________2________A______________1__________________22_________2222___2222____22_________2222____________________________________ A = 49,35 starting position
36  ________________________________________2_______________________1_________________2_______________222__________22___2222____22__________________________________
37  ________________________________________2_______________________1_________________2______________________________222_________2__________________________________
38  ________________________________________2_______________________1_________________2__________________________________________2__________________________________
39  ________________________________________2_______________________1_________________2_________________________________________2___________________________________
40  ________________________________________2_______________________1_________________2_________________________________________2___________________________________
41  ________________________________________2______________________1__________________2_________________________________________2___________________________________
42  ________________________________________2______________________1__________________2_________________________________________211111111111111111111111111111111111
43  ________________________________________2_____________________1___________________2________________________________________2________3333333333333333333332______
44  ________________________________________2_____________________1___________________2________________________________________2________333333333333333333332_______
45  ________________________________________2____________________1____________________2________________________________________211111___33333333333333333332________
46  ________________________________________2_____________________2___________________2________________________________________2_____11_3333333333333333332_________
47  ________________________________________2____________________22___________________2_______________________________________2_______11333333333333333332__________
48  _______________________________________22____________________22___________________2_______________________________________2__111113333333333333333332___________
49  _______________________________________22__________________22_2___________________2_________________________1333333333333311133333333333333333333332____________
50  ____________________________________11122________________22___2___________________2_________________________133333333333333333333333333333333333332_____________
51  ______________________________11111133_22________________2___2_____________________2________________________13333333333333333333333333333333333332______________
52  _______________________11111113333333__22________________2___2_____________________2_________________________133333333333333333333333333333333332_______________
53  _____________________113333333333333__222________________2___2_____________________2_________________________12333333333333333333333322222222222________________
54  ___________________11333333333333333__222________________2___2_____________________2_________________________1_2333333333333333333322___________________________
55  __________________13333333333333333___22_________________2___2_____________________2_________________________1__2222233333333333322_____________________________
56  __________________13333333333333333___22_________________2___2_____________________2_________________________1_______233333333322_______________________________
57  _________________133333333333333333___22_________________2___2____________________2__________________________1________222222222_________________________________
58  _________________133333333333333311112_2________________2____2____________________2__________________________1__________________________________________________
59  _________________1333333333311111____222________________2____2____________________2__________________________1__________________________________________________
60  _________________1333333333333311111_2_________________2____2_____________________2___________________________1_________________________________________________
61  __________________1333333333333333331113333333333333331_____2_____________________2___________________________1_________________________________________________
62  __________________133333333333333333333333333333333333311___2_____________________2___________________________1_________________________________________________
63  ________________113333333333333333333333333333333333333331__2_____________________2___________________________1_________________________________________________
64  ______________11333333333333333333333333333333333333333333112_____________________2___________________________1_________________________________________________
65  ______________1333333333333333333333333333333333333333333322______________________2___________________________1_________________________________________________
66  ______________13333333333333333333333333222223333333333332_________________________2__________________________1_________________________________________________
67  ______________12222333333333333322222222_____22222222222222________________________2__________________________1_________________________________________________
68  ______________1____2222222222222___________________________________________________2_________________.________1_________________________________________________
69  ______________1____________________________________________________________________2________________._________1_________________________________________________
70  ______________1____________________________________________________________________2_______________.__________1_________________________________________________
71  ___________________________________________________________________________________2______________.___________1_________________________________________________
72  ___________________________________________________________________________________2_____________._____________1________________________________________________
73  ___________________________________________________________________________________2____________.______________1________________________________________________
74  ___________________________________________________________________________________2___________._______________1________________________________________________
75  ____________________________________________________________________________________2_________.________________1________________________________________________
76  ____________________________________________________________________________________2________._________________1________________________________________________
77  ____________________________________________________________________________________2_______.__________________1________________________________________________
78  ____________________________________________________________________________________2______.___________________1________________________________________________
79  ____________________________________________________________________________________2_____._____________________1_______________________________________________
80  ____________________________________________________________________________________2____._____________.________1_______________________________________________
81  ____________________________________________________________________________________2___._____________._A........1______________________________________________
82  ____________________________________________________________________________________2__._____________.___________1______________________________________________
83  ____________________________________________________________________________________2_._____________._____________1_____________________________________________
84  ____________________________________________________________________________________2._____________.______A........1____________________________________________
85  _____________________________________________________________________________111111112____________.______________.21____________________________________________
86  ____________________________________________________________________1111111113333____2___________.______________.2__1___________________________________________
87  _______________________________________________________________111113333333333333____2__________.______________._2___1__________________________________________
88  ______________________________________________________________133333333333333333_____2_________.______________._2_______________________________________________
89  ___________222222222222222222222222222222222222222222222222__1333333333333333333_____2________.______________.__2_______________________________________________
90  ___________2______________________________________________2_13333333333333333333_____2_______.______________.__2________________________________________________
91  ___________2______________________________________________2133333333333333333333_____2______.______________.__2_________________________________________________
92  ___________2______________________________________________213333333333333333333_______2____.______________._22__________________________________________________
93  ___________2______________________________________________133333333333333333333_______2___.______________._2____________________________________________________
94  ___________2________________________________3_____________133333333333333333333_1111112__.______________._2_____________________________________________________
95  ___________2________________________________3333333333333333333333333333311111111111__2_.______________.__2_____________________________________________________
96  ___________2________________________________133333333333333333333333333333333333333312_.______________.___.2____________________________________________________
97  ___________2________________________________133333333333333333333333333333333333333312.______________.___._2____________________________________________________
98  ___________2________________________________133333333333333333333333333333333333333331______________.___.__2____________________________________________________
99  ___________2________________________________133333333333333333333333333333333333333331_____________.___.___2____________________________________________________
100 ___________2________________________________133333333333333332222333333333333333222222____________.___.____2____________________________________________________
101 ___________2________________________________13333333333222222____222222222222222_____2___________.___._____2____________________________________________________
102 ___________2_________________________________1222222222______________________________2__________.___.______2____________________________________________________
103 ____________2________________________________12_____________________________________2__________.___._______2____________________________________________________
104 ____________2________________________________12_____________________________________2_________.___.________2____________________________________________________
105 _____________2_______________________________12_____________________________________2________.___._________2____________________________________________________
106 ______________2______________________________12_____________________________________2___________.__________2____________________________________________________
107 ______________2______________________________1_2___________________________________2___________.__________2_____________________________________________________
108 _______________2_____________________________1_2___________________________________2__________.___________2_____________________________________________________
109 ________________2____________________________1__2__________________________________2_________.___________2______________________________________________________
110 ________________2____________________________1__2__________________________________2________.___________2_______________________________________________________
111 _________________2222222_____________________1___2________________________________2C_______.____________2_______________________________________________________
112 _______________________2_____________________1___2________________________________2.______.____________2________________________________________________________
113 ________________________2_____________________1___2_______________________________2._____.____________2_________________________________________________________
114 ________________________2_____________________1___2_______________________________2.____._____________2_________________________________________________________
115 ________________________2_____________________1____2_____________________________2_.___._____________2__________________________________________________________
116 _________________________2____________________1____2_____________________________2_.__.______________2__________________________________________________________
117 _________________________2____________________1____2____________________________2__._.______________2___________________________________________________________
118 _________________________2____________________1_____2___________________________2__.._______________2___________________________________________________________
119 __________________________2___________________1_____2__________________________2___.______________.2____________________________________________________________
120 __________________________2____________________1_____2_________________________2__.._____________.2_____________________________________________________________
121 __________________________2____________________1_____2________________________2__._.____________._2_____________________________________________________________
122 ___________________________2___________________1______2_______________________2_.__.___________._2______________________________________________________________
123 ___________________________2___________________1______2______________________2_.___.__________.__2______________________________________________________________
124 ___________________________2___________________1_______2_____________________2.____._________.__2_______________________________________________________________
125 ____________________________2__________________1_______2222222222222222222222._____.________.___2_______________________________________________________________
126 ____________________________2__________________1________2__________________________._______.____2_______________________________________________________________
127 ____________________________2___________________1_______2__________________________.______._____2_______________________________________________________________
128 ____________________________2___________________1_______2__________________________._____.______2_______________________________________________________________
129 _____________________________2__________________1_______2__________________________.____.______2________________________________________________________________
130 _____________________________2__________________1_______2__________________________.___._______2________________________________________________________________
131 _____________________________2__________________1_______2__________________________.__.________2________________________________________________________________
132 _____________________________2__________________1_______2__________________________._._________2________________________________________________________________
133 ______________________________2__________________1______2__________________________.._________2_________________________________________________________________
134 ______________________________2__________________1______2__________________________.__________2_________________________________________________________________
135 ______________________________22_________________1______2_________________________.._________2__________________________________________________________________
136 ______________________________22_________________1_______2_______________________._.________2__1__________________________________________1111111111111111111___
137 ______________________________2_2_________________1______2______________________.__.________211_1____________________________1111111111111333_______________1___
138 _____________________________2__2_________________1_______2________________________.________2___31___________________________1________3333333_______________1___
139 _____________________________12_2_________________1_______2________________________.________2___331__________________________1________3333333_______________1___
140 ___________________________1132_2_________________1________2_______________________.________2___33311________________________1________3333333_______________1___
141 __________________________13%32__2_________________1_______2_______________________.________2__33333311______________________1________333333________________1___
142 _________________________133%332_2_________________1________2______________________.________2__3333333311111111111___________1_________33333________________1___
143 _______________________11Q33%332_2_________________1________2______________________.________2__3333333333________1___________111111111111133________________1___
144 ____________________11133333%33_22_________________1________2______________________.________2___333333333________1_______________________1111_______________1___
145 ___________________1R333.33A%33__2__________________1_______2______________________.________2___33333333_________1____________________111333________________1___
146 ___________________1333.3333%3___22_________________1_______2______________________.________2____333_333_________1__________________11333333________________1___
147 __________________1333.33333%3____2_________________1_______2______________________.________2____333__33_________1_________________1_333333_________________1___
148 _________________1333.333333%3____2_________________1________2_____________________.________2____333___3_________1___________11111133333333_________________1___
149 _________________133.3333333%%%%%%2__________________1_______2_____________________.________21__3333___3_________1___________1333333333333__________________1___
150 ___________11111133.33333R3P33___22__________________1_______2_____________________.________2_11113______________1_________11333333333333___________________1___
151 __________13333333.33333333333__12___________________1_______2_____________________.________2_____11_____________1_______11_333333333333____________________1___
152 __________1333333.333333333333_122___________________1_______2_____________________.________2_______1_____________1___111_3333333333333_____11111111111111111___
153 _________1333333.333333333333_1_2_____________________1______2_____________________.________2_______1_____________1___13333333333333333___11____________________
154 ________1333333.33333333333331__2_____________________1______2_____________________.________2________1____________1__1_333333333333333__11______________________
155 ________133333.33333333333331__2______________________1______2_____________________._________1111111111___________1__1_33333333333333311________________________
156 _______133333.333333333W333331_2______________________1_____2______________________.________1333__________________1__1_33333333333333331________________________
157 _______13333.333333333.33333312________________________1____2______________________.________133___________________1__13333333333333333331_______________________
158 ______13333.333333333.333333332________________________1____2_______________1333333%33333333333___________________1__133333333333333333331_____1111111111_______
159 ______1333.333333333.3333333331_____A__________________1____2_______________1333333%33333333333___________________1__1333333333333333333331111133333333331111___
160 ______133.333333333.33333V333331333.333333333333333333331___2______.........1333333%33333333333___________________1__1333333333333333333333333333333333333333111
161 _______1.333333333.3333333.3333333.3333333333333333333331___2_____.__________133333%33333333333_____111111111111111__1333333333333333333333333333333333333333333
162 _______1333333333.333333333.33333.333333333333333333333331_2_____.___________133333%3333333333__1111_________________1333333333333333333333333333333333333333333
163 _______133333333.33333333333.333.3333333333333333333333331_2____.____________133333%333333333311_____________________1333333333333333333333333333333333333333333
164 _______13333333.3333333333333.3.33333333333333333333B3333312___._____________122333%33333333331______________________1333333333333333333333333333333333333333333
165 ________133333.333333333333333.3333333333333333333333333331___.______________1__22222222222221_______________________1333333333333333333333333333333333333333333
166 _______22222222222222222222222222222222222222222222222222221_._______________1_______________1_______________________2222222222222222222222222222222222222222222
167 ________1333333333333333333333333333333333333333333333333331.________________1_______________1_______________________1333333333333333333333333333333333333333333
