    0         10        20        30        40        50        60        70        80        90        100       110       120       130       140       150       
    0123456789012345678901234567890123456789012345678901234567890123456789012345678901234567890123456789012345678901234567890123456789012345678901234567890123456789
0   ________________________________________________________________________________________________________________________________________________________________
1   ________________________________________________________________________________________________________________________________________________________________
2   ________________________________________________________________________________________________________________________________________________________________
3   ________________________________________________________________________________________________________________________________________________________________
4   ________________________________________________________________________________________________________________________________________________________________
5   ________________________________________________________________________________________________________________________________________________________________
6   ________________________________________________________________________________________________________________________________________________________________
7   ________________________________________________________________________________________________________________________________________________________________
8   ________________________________________________________________________________________________________________________________________________________________
9   ________________________________________________________________________________________________________________________________________________________________
10  ________________________________________________________________________________________________________________________________________________________________
11  ________________________________________________________________________________________________________________________________________________________________
12  ________________________________________________________________________________________________________________________________________________________________
13  ________________________________________________________________________________________________________________________________________________________________
14  ________________________________________________________________________________________________________________________________________________________________
15  ________________________________________________________________________________________________________________________________________________________________
16  ________________________________________________________________________________________________________________________________________________________________
17  ________________________________________________________________________________________________________________________________________________________________
18  ________________________________________________________________________________________________________________________________________________________________
19  ________________________________________________________________________________________________________________________________________________________________
20  ________________________________________________________________________________________________________________________________________________________________
21  ________________________________________________________________________________________________________________________________________________________________
22  ________________________________________________________________________________________________________________________________________________________________
23  ________________________________________________________________________________________________________________________________________________________________
24  ________________________________________________________________________________________________________________________________________________________________
25  ________________________________________________________________________________________________________________________________________________________________
26  ________________________________________________________________________________________________________________________________________________________________
27  ________________________________________________________________________________________________________________________________________________________________
28  ________________________________________________________________________________________________________________________________________________________________
29  ________________________________________________________________________________________________________________________________________________________________
30  ____________________________________________________________________2222222222222222222222222222222222__________________________________________________________
31  ____________________________________________________________________2333333333333333333333333333333332__________________________________________________________
32  ____________________________________________________________________23333333333333333333333333333333332_________________________________________________________
33  ____________________________________________________________________23333333333333333333333333333333332_________________________________________________________
34  ____________________________________________________________________23333333333333333333333333333333332_________________________________________________________
35  ___________________________________________________________________2333333333333333333333333333333333332________________________________________________________
36  ___________________________________________________________________2333333333333333333333333333333333332________________________________________________________
37  ___________________________________________________________________2333333333333333333333333333333333332________________________________________________________
38  ___________________________________________________________________2333333333333333333333333333333333332________________________________________________________
39  ___________________________________________________________________23333333333333333333333333333333333332_______________________________________________________
40  ___________________________________________________________________23333333333333333333333333333333333332_______________________________________1111111111111111
41  ___________________________________________________________________23333333333333333333333333333333333332_____1111111111111111111111____11111111________________
42  ___________________________________________________________________23333333333333333333333333333333333332____1______________________1111________________________
43  __________________________________________________________________233333333333333333333333333333333333332__11___________________________________________________
44  ______________111111111___________________________________________233333333333333333333333333333333333332_1_____________________________________________________
45  _____________1_________11_______111_______________________________2333333333333333333333333333333333333321______________________________________________________
46  ____________1____________1__1111___11_____________________________2333333333333333333333333333333333333321______________________________________________________
47  ____________1_____________11_________11____________________1111111133333333333333333333333333333333333321_______________________________________22222___________
48  ___________1___________________________111111____________11_______13333333333333333333333333333333333331_________________22222________________22_____22222222222
49  __________1__________________________________111111_1__11_________13333333333333333333333333333333333331________________2_____2222222222222222__________________
50  __________1________________________________________1_11___________1333333333333333333331333333333333331________________2________________________________________
51  _________1________________________________________________________13333333333333333333311_____________________________2_________________________________________
52  _________1________________________________________________________13333333333333333333311____________________________2__________________________________________
53  _________1_________________________________________________________133333333333333333331_1___________________________2__________________________________________
54  ________1_________________________________________________________2133333333333333333331_1__________________________2___________________________________________
55  ________1_______________________________________________________22_13333333333333333333312_________________________2____________________________________________
56  ________1_____________________________________________________22___13333333333333333333312________________________2_____________________________________________
57  _______1____________________________________________________22_____1333333333333333333331_22222___________________2_____________________________________________
58  _______1__________________________________________________22_______1333333333333333333331______2222222222222222222______________________________________________
59  _______1__________________________22222______________22__2_________1333333333333333333331_______________________________________________________________________
60  _______1_______________22______222_____2222222____222__222_________1333333333333333333331_______________________________________________________________________
61  ______1_____________122__222222_______________2222_________________1333333333333333333331_______________________________________________________________________
62  ______1______________1____________________________________________13333333333333333333331_______________________________________________________________________
63  ______1______________1____________________________________________13333333333333333333331_______________________________________________________________________
64  _____1________________1___________________________________________13333333333333333333331_______________________________________________________________________
65  _____1_________________1__________________________________________13333333333333333333331_______________________________________________________________________
66  ______1________________1__________________________________________13333333333333333333331_______________________________________________________________________
67  ______1_________________1_________________________________________133333333333333333333331______________________________________________________________________
68  _______1_________________11_______________________________________133333333333333333333331______________________________________________________________________
69  _______1___________________11_____________________________________133333333333333333333331______________________________________________________________________
70  ________1____________________11___________________________________133333333333333333333331______________________________________________________________________
71  _______21______________________11________________________________1333333333333333333333331______________________________________________________________________
72  _______2_________________________11111111111_____________________1333333333333333333333331______________________________________________________________________
73  _______2____________________________________1111___________1____13333333333333333333333331______________________________________________________________________
74  ________2_______________________________________11111111111_1___13333333333333333333333331______________________________________________________________________
75  _________22__________________________________________________11133333333333333333333333331______________________________________________________________________
76  ___________2______________________________________________________33333333333333333333331_______________________________________________________________________
77  ____________22_______________________________________________________33333333333333333331_______________________________________________________________________
78  ______________22________________________________________________________3333333333333331________________________________________________________________________
79  ________________22_________________________________________________________________11111________________________________________________________________________
80  __________________22_________________11111_____________________________________________1________________________________________________________________________
81  ____________________22_____________11____1_____________________________________________1________________________________________________________________________
82  ______________________222_________111____1_____11111___________________________________11_______________________________________________________________________
83  _________________________222222222___11111__222_____11111111_____________________________11_________1111111111111_______________________________________________
84  _________________________________________222________________11111__________________________11___1111_____________11111__________________________________________
85  ________________________________________________________________2____________________________111______________________11111_________1111111111111111111111______
86  _________________________________________________________________22________________________________________________________111111111______________________111111
87  ___________________________________________________________________22___________________________________________________________________________________________
88  _____________________________________________________________________222________________________________________________________________________________________
89  ________________________________________________________________________222__11_________________________________________________________________________________
90  ___________________________________________________________________________22__11_______________________________________________________________________________
91  _________________________________________________________________________________111_____________________2222222________________________________________________
92  ____________________________________________________________________________________11_________________22_______2_______________________________________________
93  _____________________________________________________________________________________22______________22__________2______________________________________________
94  _______________________________________________________________________________________222______22222_____________22222_________________________________________
95  __________________________________________________________________________________________222222_______________________2______________________________________22
96  ________________________________________________________________________________________________________________________22222222222222222222222222222222222222__
97  ________________________________________________________________________________________________________________________________________________________________
98  ________________________________________________________________________________________________________________________________________________________________
99  ________________________________________________________________________________________________________________________________________________________________
100 ________________________________________________________________________________________________________________________________________________________________
101 ________________________________________________________________________________________________________________________________________________________________
102 ________________________________________________________________________________________________________________________________________________________________
103 ________________________________________________________________________________________________________________________________________________________________
104 ________________________________________________________________________________________________________________________________________________________________
105 ________________________________________________________________________________________________________________________________________________________________
106 ________________________________________________________________________________________________________________________________________________________________
107 ________________________________________________________________________________________________________________________________________________________________
108 ________________________________________________________________________________________________________________________________________________________________
109 ___________________________111111111_________________________________________________1111111111111______________________________________________________________
110 __________________________1_________1_______________________________________________1_____________11____________________________________________________________
111 _________________________1__________1_______________________________________________1_______________11__________________________________________________________
112 ________________________1____________11111111______________________________________1__________________111_______________________________________________________
113 ________________________1___________________1__________________________________1111______________________11_____________________________________________________
114 _______________________1____________________1_____________________________11111____________________________111_________________________11111111_________________
115 _______1111111111_____1_____________________1_________________________1111____________________________________11_______________111111111111111_111111___________
116 _______1_________11__1______________________11___________________11111__________________________________________11_____11111111______________________1111111____
117 _______1___________11_________________________111___________11111_________________________________________________11111_____________________________________1111
118 _______1_________________________________________111____1111____________________________________________________________________________________________________
119 ________1___________________________________________1111________________________________________________________________________________________________________
120 ________1_______________________________________________________________________________________________________________________________________________________
121 ________1_____________________________________________________111111111111______________________________________________________________________________________
122 ________1___________________________________________________11____________1111__________________________________________________________________________________
123 ________1_________________________________________________11__________________111_______________________________________________________________________________
124 ________1_______________________________________________11_______________________1______________________________________________________________________________
125 _______1______________________________________________11_________________________1______________________________________________________________________________
126 _______1_____________________________________________1___________________________1______________________________________________________________________________
127 _______1_____________________________________________1___________________________1______________________________________________________________________________
128 ______1______________________________________________1___________________________1______________________________________________________________________________
129 ______1______________________________________________1___________________________1______________________________________________________________________________
130 ______1______________________________________________1__________________________11______________________________________________________________________________
131 ______1_______________________________________1111111111______________________11__11111_________________________________________________________________________
132 ______1_________________________________________________1111_______________111__________________________________________________________________________________
133 ______1_____________________________________________________1111_________11_____________________________________________________________________________________
134 ______1_________________________________________________________111111111_______________________________________________________________________________________
135 ______1_________________________________________________________________________________________________________________________________________________________
136 ______1_________________________________________________________________________________________________________________________________________________________
137 ______1_________________________________________________________________________________________________________________________________________________________
138 ______1_________________________________________________________________________________________________________________________________________________________
139 ______1_________________________________________________________________________________________________________________________________________________________
140 ______1_________________________________________________________________________________________________________________________________________________________
141 ______1_________________________________________________________________________________________________________________________________________________________
142 ______1_________________________________________________________________________________________________________________________________________________________
143 ______1_________________________________________________________________________________________________________________________________________________________
144 ______1_________________________________________________________________________________________________________________________________________________________
145 ______1_________________________________________________________________________________________________________________________________________________________
146 ______1_________________________________________________________________________________________________________________________________________________________
147 ______1_________________________________________________________________________________________________________________________________________________________
148 ______1______________________________________________________________________________________________________________________11111______________________________
149 ______1________________________________________________________________________________________________________________111111_____111111________________________
150 ______1_____________________________________________________________________________________________________________111_________________1111____________________
151 _______1___________________________________________________________________________________________________________1________________________1___________________
152 ________1_________________________________________________________________________________________________________1__________________________1__________________
153 _________1_______________________________________________________________________________________________________1___________________________1__________________
154 __________1_____________________________________________________________________________________________________1_____________________________1_________________
155 __________1_____________________________________________________________________________________________________11111111111________________11111________________
156 ___________1_______________________________________________________________________________________________________________1111111111111111_____________________
157 ____________1___________________________________________________________________________________________________________________________________________________
158 _____________1__________________________________________________________________________________________________________________________________________________
159 ______________1_________________________________________________________________________________________________________________________________________________
160 _______________1________________________________________________________________________________________________________________________________________________
161 _______________1________________________________________________________________________________________________________________________________________________
162 _______________1________________________________________________________________________________________________________________________________________________
163 _______________1________________________________________________________________________________________________________________________________________________
164 _______________1________________________________________________________________________________________________________________________________________________
165 _______________1________________________________________________________________________________________________________________________________________________
166 _______________1________________________________________________________________________________________________________________________________________________
167 _______________1________________________________________________________________________________________________________________________________________________
