    0         10        20        30        40        50        60        70        80        90        100       110       120       130       140       150       
    0123456789012345678901234567890123456789012345678901234567890123456789012345678901234567890123456789012345678901234567890123456789012345678901234567890123456789
0   ________________________________________________________________________________________________________________________________________________________________
1   ________________________________________________________________________________________________________________________________________________________________
2   ________________________________________________________________________________________________________________________________________________________________
3   ________________________________________________________________________________________________________________________________________________________________
4   ________________________________________________________________________________________________________________________________________________________________
5   ________________________________________________________________________________________________________________________________________________________________
6   ________________________________________________________________________________________________________________________________________________________________
7   ________________________________________________________________________________________________________________________________________________________________
8   ________________________________________________________________________________________________________________________________________________________________
9   ________________________________________________________________________________________________________________________________________________________________
10  ________________________________________________________________________________________________________________________________________________________________
11  ________________________________________________________________________________________________________________________________________________________________
12  ________________________________________________________________________________________________________________________________________________________________
13  ________________________________________________________________________________________________________________________________________________________________
14  ________________________________________________________________________________________________________________________________________________________________
15  _______________________________________________________________________________________________________________________________________________________________1
16  ______________________________________________________________________________________________________________________________________________________________1_
17  _____________________________________________________________________________________________________________________________________________________________1__
18  _____________________________________________________________________________________________________________________________________________________________1__
19  ____________________________________________________________________________________________________________________________________________________________1___
20  ___________________________________________________________________________________________________________________________________________________________1____
21  __________________________________________________________________________________________________________________________________________________________1_____
22  _________________________________________________________________________________________________________________________________________________________1______
23  ________________________________________________________________________________________________________________________________________________________1_______
24  ________________________________________________________________________________________________________________________________________________________1_______
25  _______________________________________________________________________________________________________________________________________________________1________
26  ______________________________________________________________________________________________________________________________________________________1_________
27  _____________________________________________________________________________________________________________________________________________________1__________
28  ____________________________________________________________________________________________________________________________________________________1___________
29  ___________________________________________________________________________________________________________________________________________________1____________
30  ___________________________________________________________________________________________________________________________________________________1____________
31  __________________________________________________________________________________________________________________________________________________1____________1
32  _________________________________________________________________________________________________________________________________________________1____________1_
33  ________________________________________________________________________________________________________________________________________________1____________1__
34  _______________________________________________________________________________________________________________________________________________1_____________1__
35  _______________________________________________________________________________________________________________________________________________1____________1___
36  ______________________________________________________________________________________________________________________________________________1____________1____
37  _____________________________________________________________________________________________________________________________________________1____________1_____
38  ____________________________________________________________________________________________________________________________________________1____________1______
39  ___________________________________________________________________________________________________________________________________________1_____________1______
40  __________________________________________________________________________________________________________________________________________1_____________1_______
41  __________________________________________________________________________________________________________________________________________1____________1________
42  _________________________________________________________________________________________________________________________________________1____________1_________
43  ________________________________________________________________________________________________________________________________________1_____________1_________
44  _______________________________________________________________________________________________________________________________________1_____________1__________
45  ______________________________________________________________________________________________________________________________________1_____________1___________
46  _____________________________________________________________________________________________________________________________________1_____________1____________
47  _____________________________________________________________________________________________________________________________________1____________1_____________
48  ____________________________________________________________________________________________________________________________________166666666666661_____________
49  ___________________________________________________________________________________________________________________________________1_____________6______________
50  __________________________________________________________________________________________________________________________________1_____________16______________
51  _________________________________________________________________________________________________________________________________1_____________1_6______________
52  _________________________________________________________________________________________________________________________________1____________1__6______________
53  ________________________________________________________________________________________________________________________________1_____________1__6______________
54  _______________________________________________________________________________________________________________________________1_____________1___6______________
55  ______________________________________________________________________________________________________________________________1_____________1____6______________
56  _____________________________________________________________________________________________________________________________1_____________1_____6______________
57  ____________________________________________________________________________________________________________________________1_____________1______6______________
58  ____________________________________________________________________________________________________________________________1_____________1______6______________
59  ___________________________________________________________________________________________________________________________1_____________1_______6______________
60  __________________________________________________________________________________________________________________________1_____________1________6______________
61  _________________________________________________________________________________________________________________________1_____________1_________6______________
62  ________________________________________________________________________________________________________________________1______________1_________6______________
63  _______________________________________________________________________________________________________________________1______________1__________6______________
64  _______________________________________________________________________________________________________________________1_____________1___________6______________
65  ______________________________________________________________________________________________________________________1_____________1____________6______________
66  _____________________________________________________________________________________________________________________1_____________1_____________6______________
67  ____________________________________________________________________________________________________________________1______________1_____________6______________
68  ___________________________________________________________________________________________________________________1______________1______________6______________
69  ___________________________________________________________________________________________________________________1_____________1_______________6______________
70  __________________________________________________________________________________________________________________1_____________1________________6______________
71  _________________________________________________________________________________________________________________1_____________1_________________6______________
72  ________________________________________________________________________________________________________________1______________1_________________6______________
73  _______________________________________________________________________________________________________________1______________1__________________6______________
74  ______________________________________________________________________________________________________________1______________1___________________6______________
75  ______________________________________________________________________________________________________________1_____________1____________________6______________
76  _____________________________________________________________________________________________________________1______________1____________________6______________
77  ____________________________________________________________________________________________________________1______________1_____________________6______________
78  ___________________________________________________________________________________________________________1______________1______________________6______________
79  __________________________________________________________________________________________________________1______________1_______________________6______________
80  _________________________________________________________________________________________________________1______________1________________________6______________
81  _________________________________________________________________________________________________________1______________1________________________6______________
82  ________________________________________________________________________________________________________1______________1_________________________6______________
83  _______________________________________________________________________________________________________1______________1__________________________6______________
84  ______________________________________________________________________________________________________1______________1___________________________6______________
85  _____________________________________________________________________________________________________1______________1____________________________6______________
86  _____________________________________________________________________________________________________1______________1____________________________6______________
87  ____________________________________________________________________________________________________1______________1_____________________________6______________
88  ___________________________________________________________________________________________________1______________1______________________________6______________
89  __________________________________________________________________________________________________1______________1_______________________________6______________
90  _________________________________________________________________________________________________1______________1________________________________6______________
91  ________________________________________________________________________________________________1_______________1________________________________6______________
92  ________________________________________________________________________________________________1______________1_________________________________6______________
93  _______________________________________________________________________________________________1______________1__________________________________6______________
94  ______________________________________________________________________________________________1______________1___________________________________6______________
95  _____________________________________________________________________________________________1_______________1___________________________________6______________
96  ____________________________________________________________________________________________1_______________1____________________________________6______________
97  ___________________________________________________________________________________________1_______________1_____________________________________6______________
98  ___________________________________________________________________________________________1______________1______________________________________6______________
99  __________________________________________________________________________________________1______________1_______________________________________6______________
100 _________________________________________________________________________________________1_______________1_______________________________________6______________
101 ________________________________________________________________________________________1_______________1________________________________________6______________
102 ______________________________________1111111111111111_________________________________1_______________1_________________________________________6______________
103 ______________________________________1______________1_________________________________1______________1__________________________________________6______________
104 ______________________________________1______________1________________________________1______________1___________________________________________6______________
105 ______________________________________1______________1_______________________________1_______________1___________________________________________6______________
106 ______________________________________1______________1______________________________1_______________1____________________________________________6______________
107 ______________________________________1______________1_____________________________1_______________1_____________________________________________6______________
108 ______________________________________1______________1____________________________1_______________1______________________________________________6______________
109 ______________________________________1______________1____________________________1______________1_______________________________________________6______________
110 ______________________________________1______________1___________________________1_______________1_______________________________________________6______________
111 ______________________________________1______________1__________________________1_______________1________________________________________________6______________
112 ______________________________________1______________1_________________________1_______________1_________________________________________________6______________
113 ______________________________________1______________1________________________1_______________1__________________________________________________6______________
114 ______________________________________1______________1_______________________1________________1__________________________________________________6______________
115 ______________________________________1______________1_______________________1_______________1___________________________________________________6______________
116 ______________________________________1______________1______________________1_______________1____________________________________________________6______________
117 ______________________________________1______________1_____________111111111_______________1_____________________________________________________6______________
118 ______________________________________1______________1_____________1______________________1______________________________________________________6______________
119 ______________________________________1______________1_____________1______________________1______________________________________________________6______________
120 __________________________1111111111111______________111111111111111_____________________1_______________________________________________________6______________
121 __________________________1_____________________________________________________________1________________________________________________________6______________
122 ______________________1111______________________________________________________________1________________________________________________________6______________
123 ______________________1_______________________________________________________________11_________________________________________________________6______________
124 ______________________1______________________________________________________________1___________________________________________________________6______________
125 _____________________1______________________________________________________________1____________________________________________________________6______________
126 _____________________1______________________________________________________________1____________________________________________________________6______________
127 _____________________1_____________________________________________________________1_____________________________________________________________6______________
128 _____________________1____________________________________________________________1______________________________________________________________6______________
129 ____________________1____________________________________________________________11______________________________________________________________6______________
130 ____________________1_____________________________________________________________1______________________________________________________________6______________
131 ____________________1_____________________________________________________________1______________________________________________________________6______________
132 ____________________1____________________________________________________________111111111111111111111111111111111111___1111111111111111111111111611111111111111
133 ___________________1_________________________________________________________________________________________________1___1_______________________6_____________1
134 ___________________1__________________________________________________________________________________________________1111_______________________6_____________1
135 ___________________1_____________________________________________________________________________________________________________________________6_____________1
136 ___________________1_____________________________________________________________________________________________________________________________6_____________1
137 __________________1______________________________________________________________________________________________________________________________6_____________1
138 __________________1______________________________________________________________________________________________________________________________6_____________1
139 __________________1______________________________________________________________________________________________________________________________6_____________1
140 __________________1______________________________________________________________________________________________________________________________6_____________1
141 _________________1_______________________________________________________________________________________________________________________________6_____________1
142 _________________1_______________________________________________________________________________________________________________________________6_____________1
143 _________________1_______________________________________________11111111111111111111111111111111111111__________________________________________6_____________1
144 _________________1_______________________________________________1___________________________________11__________________________________________6_____________1
145 _________________1_______________________________________________1__________________________________1_1__________________________________________6_____________1
146 ________________1_________________________________________________1________________________________1__1__________________________________________6_____________1
147 ________________1_________________________________________________1_______________________________1___1__________________________________________6_____________1
148 ________________1_________________________________________________1______________________________1____1__________________________________________6_____________1
149 ________________1_________________________________________________1_____________________________1_____1__________________________________________6_____________1
150 _______________1___________________________________________________1___________________________1_____1___________________________________________6_____________1
151 _______________1___________________________________________________1___________________________1____1____________________________________________6_____________1
152 _______________1___________________________________________________1__________________________1____1_____________________________________________6_____________1
153 _______________1___________________________________________________1_________________________1____1______________________________________________6_____________1
154 ______________1_____________________________________________________1_______________________1____1_______________________________________________6_____________1
155 ______________1_____________________________________________________1______________________1____1________________________________________________6_____________1
156 ______________1_____________________________________________________1_____________________1____1_________________________________________________6_____________1
157 ______________1_____________________________________________________1____________________1____1__________________________________________________6_____________1
158 _____________1_______________________________________________________1__________________1____1___________________________________________________6_____________1
159 _____________1_______________________________________________________1_________________1_____1___________________________________________________6_____________1
160 _____________1_______________________________________________________1________________1_____1____________________________________________________6_____________1
161 _____________1_______________________________________________________1_______________1_____1_____________________________________________________6_____________1
162 ____________1_________________________________________________________1_____________1_____1______________________________________________________6_____________1
163 ____________1_________________________________________________________1_____________1____1_______________________________________________________6_____________1
164 ____________11111111111111111111111111111111111111111111111111111111111____________1____1_________________________1111111111111111111111111111111111111111111111
165 __________________________________________________________________________________1____1________________________11______________________________________________
166 _________________________________________________________________________________1____1________________________1________________________________________________
167 ________________________________________________________________________________1____1________________________1_________________________________________________
